//MAP CONVERTED BY dmm2tgm.py THIS HEADER COMMENT PREVENTS RECONVERSION, DO NOT REMOVE
"bv" = (
/obj/machinery/door/poddoor/preopen/personal_bay_one,
/obj/machinery/button/door/personal_shuttle_bay_one/directional/north,
/obj/machinery/atmos_shield_gen/active{
	dir = 2
	},
/turf/open/floor/plating/nanocarbon,
/area/shuttle/personally_bought/do_it_yourself_small)
"ez" = (
/obj/machinery/power/shuttle_engine/heater{
	dir = 8
	},
/obj/structure/engine_covers/heater_cover{
	dir = 4
	},
/turf/open/floor/plating/nanocarbon/airless,
/area/shuttle/personally_bought/do_it_yourself_small)
"fI" = (
/obj/machinery/atmospherics/pipe/smart/manifold4w/supply/hidden/layer4,
/obj/machinery/wall_healer/free/directional/south,
/obj/machinery/light/warm/directional/south,
/turf/open/floor/plating/nanocarbon,
/area/shuttle/personally_bought/do_it_yourself_small)
"gb" = (
/obj/machinery/atmospherics/pipe/smart/manifold4w/supply/hidden/layer4,
/obj/structure/closet/firecloset/shuttle/solo,
/obj/machinery/light/warm/directional/west,
/turf/open/floor/plating/nanocarbon,
/area/shuttle/personally_bought/do_it_yourself_small)
"gH" = (
/obj/structure/shuttle_decoration/ladder/directional/north,
/turf/closed/wall/mineral/nanocarbon/nodiagonal/primary_colour,
/area/shuttle/personally_bought/do_it_yourself_small)
"iv" = (
/obj/machinery/atmospherics/components/unary/vent_pump/on/layer4{
	dir = 1
	},
/turf/open/floor/plating/nanocarbon,
/area/shuttle/personally_bought/do_it_yourself_small)
"jv" = (
/obj/machinery/atmospherics/components/unary/vent_pump/on/layer4{
	dir = 4
	},
/obj/machinery/suit_storage_unit/industrial/personal_shuttle,
/obj/machinery/light/red/dim/directional/west,
/turf/open/floor/plating/nanocarbon,
/area/shuttle/personally_bought/do_it_yourself_small)
"pS" = (
/obj/structure/mineral_door/manual_colony_door/shuttle/interior,
/obj/structure/cable,
/turf/open/floor/plating/nanocarbon,
/area/shuttle/personally_bought/do_it_yourself_small)
"rW" = (
/obj/docking_port/mobile/personally_bought,
/obj/structure/fans/tiny,
/obj/effect/mapping_helpers/airlock/cyclelink_helper{
	dir = 1
	},
/obj/machinery/door/airlock/spacer,
/turf/open/floor/plating/nanocarbon,
/area/shuttle/personally_bought/do_it_yourself_small)
"tG" = (
/obj/machinery/light/red/directional/north,
/turf/open/floor/plating/aluminum,
/area/shuttle/personally_bought/do_it_yourself_small)
"uM" = (
/obj/structure/shuttle_decoration/bullbar/directional/east,
/obj/structure/shuttle_decoration/headlight/directional/east,
/turf/closed/wall/mineral/nanocarbon/nodiagonal/primary_colour,
/area/shuttle/personally_bought/do_it_yourself_small)
"yi" = (
/obj/structure/mineral_door/manual_colony_door/shuttle/interior,
/obj/machinery/atmospherics/pipe/smart/manifold4w/supply/hidden/layer4,
/turf/open/floor/plating/nanocarbon,
/area/shuttle/personally_bought/do_it_yourself_small)
"yZ" = (
/turf/closed/wall/mineral/nanocarbon/black,
/area/shuttle/personally_bought/do_it_yourself_small)
"zd" = (
/obj/structure/closet/crate/cardboard/mothic,
/obj/item/construction/rtd/loaded{
	pixel_y = 7
	},
/obj/item/airlock_painter{
	pixel_y = -7
	},
/obj/item/airlock_painter/decal,
/obj/item/rcd_ammo,
/obj/structure/extinguisher_cabinet/directional/north,
/turf/open/floor/plating/nanocarbon,
/area/shuttle/personally_bought/do_it_yourself_small)
"Av" = (
/obj/machinery/exoscanner/shuttle_part/radio_dish/directional/east,
/turf/closed/wall/mineral/nanocarbon/nodiagonal/secondary_colour,
/area/shuttle/personally_bought/do_it_yourself_small)
"CC" = (
/obj/structure/engine_covers/heater_cover{
	dir = 1
	},
/obj/machinery/computer/camera_advanced/shuttle_docker/personally_bought{
	y_offset = 3
	},
/obj/item/radio/intercom/directional/west,
/turf/open/floor/plating/nanocarbon,
/area/shuttle/personally_bought/do_it_yourself_small)
"CO" = (
/obj/structure/chair/comfy/shuttle{
	dir = 1
	},
/obj/machinery/atmospherics/components/unary/vent_pump/on/layer4{
	dir = 8
	},
/turf/open/floor/plating/nanocarbon,
/area/shuttle/personally_bought/do_it_yourself_small)
"CU" = (
/obj/machinery/atmospherics/pipe/smart/manifold4w/supply/hidden/layer4,
/turf/open/floor/plating/nanocarbon,
/area/shuttle/personally_bought/do_it_yourself_small)
"DW" = (
/obj/machinery/power/micro_reactor,
/obj/structure/cable,
/obj/machinery/light/blacklight/directional/west,
/turf/open/floor/plating/nanocarbon,
/area/shuttle/personally_bought/do_it_yourself_small)
"Em" = (
/obj/structure/shuttle_decoration/rcs/directional/north,
/turf/closed/wall/mineral/nanocarbon/nodiagonal/black,
/area/shuttle/personally_bought/do_it_yourself_small)
"Ew" = (
/obj/machinery/power/shuttle_engine/propulsion{
	dir = 8
	},
/obj/structure/engine_covers/thruster_nozzle{
	dir = 8
	},
/turf/open/floor/plating/nanocarbon/airless,
/area/shuttle/personally_bought/do_it_yourself_small)
"ER" = (
/turf/closed/wall/mineral/nanocarbon/nodiagonal/secondary_colour,
/area/shuttle/personally_bought/do_it_yourself_small)
"Fi" = (
/turf/open/floor/plating/aluminum,
/area/shuttle/personally_bought/do_it_yourself_small)
"Fo" = (
/obj/structure/window/fulltile/salvage_shuttle,
/obj/machinery/door/poddoor/preopen/personal_shuttle_windows,
/turf/open/floor/plating/nanocarbon,
/area/shuttle/personally_bought/do_it_yourself_small)
"Gm" = (
/obj/machinery/holopad,
/obj/machinery/button/door/personal_shuttle_windows/directional/north,
/turf/open/floor/plating/nanocarbon,
/area/shuttle/personally_bought/do_it_yourself_small)
"HU" = (
/turf/closed/wall/mineral/nanocarbon/secondary_colour,
/area/shuttle/personally_bought/do_it_yourself_small)
"Im" = (
/obj/machinery/atmospherics/components/unary/vent_pump/on/layer4{
	dir = 4
	},
/obj/machinery/power/apc/auto_name/directional/south,
/obj/effect/mapping_helpers/apc/unlocked,
/obj/effect/mapping_helpers/apc/cell_5k,
/obj/structure/cable,
/turf/open/floor/plating/nanocarbon,
/area/shuttle/personally_bought/do_it_yourself_small)
"In" = (
/turf/closed/wall/mineral/aluminum,
/area/shuttle/personally_bought/do_it_yourself_small)
"IH" = (
/obj/structure/engine_covers/heater_cover{
	dir = 1
	},
/obj/machinery/computer/shuttle/personally_bought,
/turf/open/floor/plating/nanocarbon,
/area/shuttle/personally_bought/do_it_yourself_small)
"JC" = (
/obj/machinery/atmospherics/pipe/smart/manifold4w/supply/hidden/layer4,
/obj/structure/mineral_door/manual_colony_door/shuttle,
/turf/open/floor/plating/nanocarbon,
/area/shuttle/personally_bought/do_it_yourself_small)
"KN" = (
/obj/machinery/atmospherics/pipe/smart/manifold4w/supply/hidden/layer4,
/obj/effect/landmark/ship_captain_spawner,
/turf/open/floor/plating/nanocarbon,
/area/shuttle/personally_bought/do_it_yourself_small)
"KV" = (
/obj/structure/shuttle_decoration/extinguisher/directional/west,
/turf/closed/wall/mineral/nanocarbon/nodiagonal/black,
/area/shuttle/personally_bought/do_it_yourself_small)
"LH" = (
/obj/structure/shuttle_decoration/rcs/directional/south,
/turf/closed/wall/mineral/nanocarbon/nodiagonal/primary_colour,
/area/shuttle/personally_bought/do_it_yourself_small)
"LV" = (
/obj/structure/shuttle_decoration/ladder/directional/south,
/turf/closed/wall/mineral/nanocarbon/nodiagonal/primary_colour,
/area/shuttle/personally_bought/do_it_yourself_small)
"Pp" = (
/obj/structure/mineral_door/manual_colony_door/shuttle,
/obj/machinery/atmospherics/pipe/smart/manifold4w/supply/hidden/layer4,
/turf/open/floor/plating/nanocarbon,
/area/shuttle/personally_bought/do_it_yourself_small)
"PY" = (
/obj/machinery/atmospherics/pipe/smart/manifold4w/supply/hidden/layer4,
/obj/machinery/vending/wallmed/directional/south,
/obj/structure/extinguisher_cabinet/directional/north,
/turf/open/floor/plating/nanocarbon,
/area/shuttle/personally_bought/do_it_yourself_small)
"Qm" = (
/obj/machinery/portable_atmospherics/canister/air,
/obj/machinery/atmospherics/components/unary/portables_connector/visible/layer4,
/obj/machinery/airalarm/directional/north,
/obj/effect/mapping_helpers/airalarm/all_access,
/turf/open/floor/plating/nanocarbon,
/area/shuttle/personally_bought/do_it_yourself_small)
"QI" = (
/turf/closed/wall/mineral/nanocarbon/nodiagonal/black,
/area/shuttle/personally_bought/do_it_yourself_small)
"QT" = (
/turf/open/floor/plating/nanocarbon,
/area/shuttle/personally_bought/do_it_yourself_small)
"RS" = (
/obj/structure/shuttle_decoration/radiator/directional/west,
/turf/closed/wall/mineral/nanocarbon/nodiagonal/black,
/area/shuttle/personally_bought/do_it_yourself_small)
"Ti" = (
/turf/closed/wall/mineral/nanocarbon/primary_colour,
/area/shuttle/personally_bought/do_it_yourself_small)
"To" = (
/obj/machinery/door/poddoor/preopen/personal_bay_one,
/obj/machinery/atmos_shield_gen/active{
	dir = 1
	},
/obj/machinery/button/door/personal_shuttle_bay_one/directional/south,
/turf/open/floor/plating/nanocarbon,
/area/shuttle/personally_bought/do_it_yourself_small)
"Ur" = (
/turf/closed/wall/mineral/nanocarbon/nodiagonal/primary_colour,
/area/shuttle/personally_bought/do_it_yourself_small)
"Wb" = (
/obj/structure/shuttle_decoration/rcs/directional/north,
/turf/closed/wall/mineral/nanocarbon/nodiagonal/primary_colour,
/area/shuttle/personally_bought/do_it_yourself_small)
"YC" = (
/turf/template_noop,
/area/template_noop)
"YR" = (
/obj/structure/shuttle_decoration/rcs/directional/south,
/turf/closed/wall/mineral/nanocarbon/nodiagonal/black,
/area/shuttle/personally_bought/do_it_yourself_small)

(1,1,1) = {"
YC
YC
RS
KV
RS
YC
YC
"}
(2,1,1) = {"
yZ
Ew
QI
DW
QI
Ew
yZ
"}
(3,1,1) = {"
Em
ez
QI
pS
QI
ez
YR
"}
(4,1,1) = {"
gH
Qm
gb
Im
In
jv
LV
"}
(5,1,1) = {"
Ur
zd
KN
CU
JC
CU
rW
"}
(6,1,1) = {"
ER
In
yi
In
In
PY
ER
"}
(7,1,1) = {"
ER
QT
CU
iv
In
Pp
ER
"}
(8,1,1) = {"
Wb
tG
Fi
Fi
CC
fI
LH
"}
(9,1,1) = {"
Ur
Fi
Fi
Fi
IH
CO
Fo
"}
(10,1,1) = {"
ER
ER
bv
To
Ur
Gm
Fo
"}
(11,1,1) = {"
HU
Av
YC
YC
uM
Fo
Ti
"}
