//MAP CONVERTED BY dmm2tgm.py THIS HEADER COMMENT PREVENTS RECONVERSION, DO NOT REMOVE
"bN" = (
/obj/machinery/button/door/personal_shuttle_bay_two/directional/south,
/obj/machinery/light/cold/directional/east,
/turf/open/floor/plating,
/area/shuttle/personally_bought/do_it_yourself_large)
"cq" = (
/obj/machinery/power/shuttle_engine/propulsion{
	dir = 8
	},
/obj/effect/turf_decal/stripes/line{
	dir = 8
	},
/obj/structure/disposalpipe/trunk{
	dir = 4
	},
/turf/open/floor/plating/airless,
/area/shuttle/personally_bought/do_it_yourself_large)
"cu" = (
/obj/machinery/modular_computer/preset/engineering{
	dir = 1
	},
/obj/structure/cable,
/obj/effect/turf_decal/bot_white,
/obj/machinery/digital_clock/directional/south,
/turf/open/floor/iron/dark/smooth_large,
/area/shuttle/personally_bought/do_it_yourself_large)
"cL" = (
/obj/machinery/suit_storage_unit/industrial/personal_shuttle,
/obj/effect/turf_decal/bot_white,
/turf/open/floor/iron/dark/smooth_large,
/area/shuttle/personally_bought/do_it_yourself_large)
"eo" = (
/obj/structure/closet/firecloset/shuttle/tools,
/obj/machinery/atmospherics/pipe/smart/manifold4w/supply/hidden/layer4,
/obj/machinery/atmospherics/components/unary/vent_scrubber/on/layer2{
	dir = 1
	},
/obj/effect/turf_decal/bot_white,
/obj/machinery/airalarm/directional/south,
/obj/effect/mapping_helpers/airalarm/all_access,
/obj/machinery/light/cold/directional/south,
/turf/open/floor/iron/dark/smooth_large,
/area/shuttle/personally_bought/do_it_yourself_large)
"eL" = (
/obj/machinery/power/shuttle_engine/propulsion{
	dir = 8
	},
/obj/effect/turf_decal/stripes/line{
	dir = 8
	},
/obj/effect/turf_decal/stripes/corner,
/obj/machinery/atmospherics/components/unary/passive_vent/layer2{
	dir = 4
	},
/turf/open/floor/plating/airless,
/area/shuttle/personally_bought/do_it_yourself_large)
"fm" = (
/obj/structure/cable,
/obj/machinery/atmospherics/components/unary/vent_scrubber/on/layer2{
	dir = 8
	},
/turf/open/floor/iron/smooth,
/area/shuttle/personally_bought/do_it_yourself_large)
"hh" = (
/obj/machinery/power/shuttle_engine/propulsion{
	dir = 8
	},
/obj/effect/turf_decal/stripes/line{
	dir = 8
	},
/turf/open/floor/plating/airless,
/area/shuttle/personally_bought/do_it_yourself_large)
"hk" = (
/obj/structure/cable,
/obj/machinery/atmospherics/pipe/smart/manifold4w/supply/hidden/layer4,
/obj/machinery/atmospherics/pipe/smart/manifold4w/scrubbers/hidden/layer2,
/obj/effect/turf_decal/delivery/white,
/obj/machinery/door/airlock/engineering,
/turf/open/floor/iron/dark/smooth_large,
/area/shuttle/personally_bought/do_it_yourself_large)
"hJ" = (
/obj/machinery/power/shuttle_engine/heater{
	dir = 8
	},
/obj/structure/window/reinforced/plasma/spawner/directional/east,
/obj/effect/turf_decal/stripes/line{
	dir = 6
	},
/obj/machinery/atmospherics/pipe/smart/manifold4w/scrubbers/hidden/layer2,
/turf/open/floor/plating/airless,
/area/shuttle/personally_bought/do_it_yourself_large)
"in" = (
/obj/machinery/atmospherics/components/unary/vent_scrubber/on/layer2{
	dir = 4
	},
/turf/open/floor/plating,
/area/shuttle/personally_bought/do_it_yourself_large)
"je" = (
/obj/structure/marker_beacon/olive,
/turf/closed/wall/mineral/titanium,
/area/shuttle/personally_bought/do_it_yourself_large)
"jT" = (
/obj/structure/extinguisher_cabinet/directional/north,
/turf/open/floor/plating,
/area/shuttle/personally_bought/do_it_yourself_large)
"kA" = (
/obj/structure/railing/eva_handhold/directional/north,
/obj/item/tether_anchor{
	anchored = 1
	},
/turf/closed/wall/mineral/titanium/nodiagonal,
/area/shuttle/personally_bought/do_it_yourself_large)
"lk" = (
/obj/structure/cable,
/obj/machinery/atmospherics/pipe/smart/manifold4w/supply/hidden/layer4,
/obj/machinery/atmospherics/pipe/smart/manifold4w/scrubbers/hidden/layer2,
/obj/effect/turf_decal/delivery/white,
/obj/machinery/door/airlock/hatch,
/turf/open/floor/iron/dark/smooth_large,
/area/shuttle/personally_bought/do_it_yourself_large)
"mb" = (
/obj/structure/marker_beacon/burgundy,
/turf/closed/wall/mineral/plastitanium,
/area/shuttle/personally_bought/do_it_yourself_large)
"mY" = (
/obj/machinery/atmospherics/pipe/smart/manifold4w/supply/hidden/layer4,
/obj/machinery/atmospherics/pipe/smart/manifold4w/scrubbers/hidden/layer2,
/turf/open/floor/plating,
/area/shuttle/personally_bought/do_it_yourself_large)
"na" = (
/obj/machinery/atmospherics/pipe/smart/manifold4w/supply/hidden/layer4,
/obj/machinery/atmospherics/pipe/smart/manifold4w/scrubbers/hidden/layer2,
/obj/effect/turf_decal/delivery/white,
/obj/structure/cable,
/obj/machinery/door/airlock/engineering,
/turf/open/floor/iron/dark/smooth_large,
/area/shuttle/personally_bought/do_it_yourself_large)
"nD" = (
/obj/machinery/computer/camera_advanced/shuttle_docker/personally_bought{
	x_offset = -5;
	y_offset = -5;
	view_range = 4
	},
/obj/effect/turf_decal/bot_white,
/turf/open/floor/iron/dark/smooth_large,
/area/shuttle/personally_bought/do_it_yourself_large)
"nJ" = (
/obj/structure/cable,
/obj/machinery/atmospherics/components/unary/vent_pump/on/layer4{
	dir = 8
	},
/turf/open/floor/plating,
/area/shuttle/personally_bought/do_it_yourself_large)
"oA" = (
/obj/structure/cable,
/obj/machinery/atmospherics/pipe/smart/manifold4w/supply/hidden/layer4,
/obj/machinery/atmospherics/pipe/smart/manifold4w/scrubbers/hidden/layer2,
/obj/effect/turf_decal/delivery/white,
/obj/machinery/door/airlock/atmos,
/turf/open/floor/iron/dark/smooth_large,
/area/shuttle/personally_bought/do_it_yourself_large)
"pq" = (
/obj/machinery/atmospherics/pipe/smart/manifold4w/supply/hidden/layer4,
/obj/machinery/atmospherics/pipe/smart/manifold4w/scrubbers/hidden/layer2,
/turf/open/floor/catwalk_floor/iron_dark,
/area/shuttle/personally_bought/do_it_yourself_large)
"ql" = (
/obj/machinery/portable_atmospherics/canister,
/obj/machinery/atmospherics/components/unary/portables_connector/visible/layer2{
	dir = 4
	},
/obj/effect/turf_decal/bot_white,
/turf/open/floor/iron/dark/smooth_large,
/area/shuttle/personally_bought/do_it_yourself_large)
"qE" = (
/obj/machinery/atmospherics/components/unary/vent_pump/on/layer4{
	dir = 4
	},
/obj/machinery/light/cold/directional/south,
/turf/open/floor/plating,
/area/shuttle/personally_bought/do_it_yourself_large)
"rf" = (
/obj/structure/table/reinforced,
/obj/machinery/recharger,
/obj/machinery/light/warm/directional/south,
/obj/machinery/vending/wallmed/directional/south,
/turf/open/floor/iron/dark/smooth_large,
/area/shuttle/personally_bought/do_it_yourself_large)
"sn" = (
/obj/structure/marker_beacon/bronze,
/turf/closed/wall/mineral/titanium,
/area/shuttle/personally_bought/do_it_yourself_large)
"sI" = (
/obj/machinery/portable_atmospherics/canister/oxygen,
/obj/machinery/atmospherics/components/unary/vent_scrubber/on/layer2{
	dir = 4
	},
/obj/effect/turf_decal/bot_white,
/obj/machinery/light/red/dim/directional/west,
/turf/open/floor/iron/dark/smooth_large,
/area/shuttle/personally_bought/do_it_yourself_large)
"tC" = (
/obj/machinery/atmospherics/components/unary/vent_pump/on/layer4{
	dir = 8
	},
/obj/structure/extinguisher_cabinet/directional/east,
/turf/open/floor/iron/smooth,
/area/shuttle/personally_bought/do_it_yourself_large)
"tF" = (
/obj/effect/turf_decal/bot_red,
/obj/machinery/holopad,
/obj/structure/cable,
/obj/machinery/button/door/personal_shuttle_windows/directional/north,
/turf/open/floor/iron/dark/smooth_large,
/area/shuttle/personally_bought/do_it_yourself_large)
"tO" = (
/obj/structure/extinguisher_cabinet/directional/east,
/obj/machinery/light/cold/directional/east,
/turf/open/floor/plating,
/area/shuttle/personally_bought/do_it_yourself_large)
"uw" = (
/obj/item/storage/toolbox/emergency,
/obj/item/binoculars,
/obj/item/trench_tool,
/obj/effect/turf_decal/bot_white,
/obj/structure/secure_safe/directional/north,
/obj/structure/extinguisher_cabinet/directional/west,
/obj/structure/shelf,
/turf/open/floor/iron/dark/smooth_large,
/area/shuttle/personally_bought/do_it_yourself_large)
"uF" = (
/obj/machinery/power/shuttle_engine/heater{
	dir = 8
	},
/obj/effect/turf_decal/stripes/line{
	dir = 4
	},
/obj/structure/window/reinforced/plasma/spawner/directional/east,
/turf/open/floor/plating/airless,
/area/shuttle/personally_bought/do_it_yourself_large)
"uT" = (
/obj/structure/marker_beacon/olive,
/turf/closed/wall/mineral/titanium/nodiagonal,
/area/shuttle/personally_bought/do_it_yourself_large)
"wU" = (
/obj/machinery/atmospherics/components/unary/vent_pump/on/layer4,
/turf/open/floor/plating,
/area/shuttle/personally_bought/do_it_yourself_large)
"xh" = (
/obj/machinery/atmospherics/pipe/smart/manifold4w/supply/hidden/layer4,
/obj/machinery/atmospherics/pipe/smart/manifold4w/scrubbers/hidden/layer2,
/obj/effect/turf_decal/delivery/white,
/obj/machinery/door/airlock/external,
/obj/effect/mapping_helpers/airlock/cyclelink_helper,
/turf/open/floor/iron/dark/smooth_large,
/area/shuttle/personally_bought/do_it_yourself_large)
"xW" = (
/turf/template_noop,
/area/template_noop)
"yx" = (
/obj/machinery/computer/shuttle/personally_bought,
/obj/effect/turf_decal/bot_white,
/turf/open/floor/iron/dark/smooth_large,
/area/shuttle/personally_bought/do_it_yourself_large)
"yK" = (
/obj/structure/cable,
/obj/machinery/atmospherics/pipe/smart/manifold4w/scrubbers/hidden/layer2,
/obj/machinery/atmospherics/components/unary/vent_pump/on/layer4{
	dir = 8
	},
/turf/open/floor/iron/smooth,
/area/shuttle/personally_bought/do_it_yourself_large)
"zo" = (
/obj/effect/spawner/structure/window/reinforced/shuttle,
/obj/structure/cable,
/obj/machinery/door/poddoor/preopen/personal_shuttle_windows,
/turf/open/floor/plating,
/area/shuttle/personally_bought/do_it_yourself_large)
"zC" = (
/obj/machinery/button/door/personal_shuttle_bay_one/directional/north,
/obj/structure/extinguisher_cabinet/directional/west,
/turf/open/floor/plating,
/area/shuttle/personally_bought/do_it_yourself_large)
"zH" = (
/obj/machinery/button/door/personal_shuttle_bay_one/directional/north,
/turf/open/floor/plating,
/area/shuttle/personally_bought/do_it_yourself_large)
"zJ" = (
/obj/structure/closet/crate/cardboard/mothic,
/obj/item/construction/rtd/loaded{
	pixel_y = 7
	},
/obj/item/airlock_painter/decal,
/obj/item/airlock_painter{
	pixel_y = -7
	},
/obj/item/rcd_ammo,
/obj/item/rcd_ammo,
/obj/item/rcd_ammo,
/turf/open/floor/plating,
/area/shuttle/personally_bought/do_it_yourself_large)
"Ae" = (
/obj/structure/railing/eva_handhold/directional/north,
/turf/closed/wall/mineral/titanium/nodiagonal,
/area/shuttle/personally_bought/do_it_yourself_large)
"AT" = (
/obj/machinery/power/apc/auto_name/directional/west,
/obj/structure/cable,
/obj/effect/mapping_helpers/apc/unlocked,
/obj/effect/mapping_helpers/apc/cell_10k,
/turf/open/floor/plating,
/area/shuttle/personally_bought/do_it_yourself_large)
"AW" = (
/obj/machinery/digital_clock/directional/south,
/turf/open/floor/plating,
/area/shuttle/personally_bought/do_it_yourself_large)
"Bb" = (
/obj/machinery/atmospherics/pipe/smart/manifold4w/scrubbers/hidden/layer2,
/obj/machinery/atmospherics/components/unary/vent_pump/on/layer4{
	dir = 4
	},
/turf/open/floor/iron/smooth,
/area/shuttle/personally_bought/do_it_yourself_large)
"Bh" = (
/obj/machinery/button/door/personal_shuttle_bay_one/directional/north,
/obj/machinery/light/cold/directional/east,
/turf/open/floor/plating,
/area/shuttle/personally_bought/do_it_yourself_large)
"Bu" = (
/obj/structure/cable,
/obj/machinery/atmospherics/pipe/smart/manifold4w/supply/hidden/layer4,
/obj/machinery/atmospherics/pipe/smart/manifold4w/scrubbers/hidden/layer2,
/turf/open/floor/plating,
/area/shuttle/personally_bought/do_it_yourself_large)
"CL" = (
/obj/machinery/atmospherics/pipe/smart/manifold4w/supply/hidden/layer4,
/obj/machinery/atmospherics/pipe/smart/manifold4w/scrubbers/hidden/layer2,
/obj/effect/turf_decal/delivery/white,
/obj/machinery/door/airlock/hatch,
/obj/structure/cable,
/turf/open/floor/iron/dark/smooth_large,
/area/shuttle/personally_bought/do_it_yourself_large)
"DD" = (
/obj/effect/turf_decal/delivery/white,
/obj/machinery/door/airlock/external,
/obj/effect/mapping_helpers/airlock/cyclelink_helper{
	dir = 1
	},
/obj/machinery/atmospherics/pipe/smart/manifold4w/supply/hidden/layer4,
/turf/open/floor/iron/dark/smooth_large,
/area/shuttle/personally_bought/do_it_yourself_large)
"DJ" = (
/obj/item/tether_anchor{
	anchored = 1
	},
/turf/closed/wall/mineral/titanium/nodiagonal,
/area/shuttle/personally_bought/do_it_yourself_large)
"Eg" = (
/obj/machinery/atmospherics/pipe/smart/manifold4w/supply/hidden/layer4,
/obj/machinery/atmospherics/pipe/smart/manifold4w/scrubbers/hidden/layer2,
/obj/structure/cable,
/turf/open/floor/plating,
/area/shuttle/personally_bought/do_it_yourself_large)
"Er" = (
/obj/machinery/atmospherics/components/unary/vent_scrubber/on/layer2,
/obj/effect/turf_decal/bot_white,
/obj/structure/extinguisher_cabinet/directional/north,
/obj/machinery/light/cold/directional/north,
/obj/machinery/recharge_station,
/turf/open/floor/iron/dark/smooth_large,
/area/shuttle/personally_bought/do_it_yourself_large)
"EY" = (
/obj/machinery/recharge_station,
/obj/machinery/atmospherics/components/unary/vent_scrubber/on/layer2,
/obj/effect/turf_decal/bot_white,
/turf/open/floor/iron/dark/smooth_large,
/area/shuttle/personally_bought/do_it_yourself_large)
"Fc" = (
/obj/machinery/portable_atmospherics/canister/air,
/obj/machinery/atmospherics/components/unary/portables_connector/visible/layer4{
	dir = 4
	},
/obj/effect/turf_decal/bot_white,
/turf/open/floor/iron/dark/smooth_large,
/area/shuttle/personally_bought/do_it_yourself_large)
"FM" = (
/obj/effect/turf_decal/delivery,
/obj/machinery/door/poddoor/preopen/personal_bay_one,
/obj/structure/holosign/barrier/atmos/sturdy,
/turf/open/floor/iron/dark/smooth_large,
/area/shuttle/personally_bought/do_it_yourself_large)
"Gp" = (
/obj/machinery/power/shuttle_engine/heater{
	dir = 8
	},
/obj/effect/turf_decal/stripes/line{
	dir = 4
	},
/obj/structure/window/reinforced/plasma/spawner/directional/east,
/obj/structure/disposalpipe/segment{
	dir = 4
	},
/turf/open/floor/plating/airless,
/area/shuttle/personally_bought/do_it_yourself_large)
"Gs" = (
/obj/machinery/atmospherics/components/unary/vent_pump/on/layer4{
	dir = 1
	},
/turf/open/floor/plating,
/area/shuttle/personally_bought/do_it_yourself_large)
"GD" = (
/obj/structure/railing/eva_handhold/directional/south,
/turf/closed/wall/mineral/titanium/nodiagonal,
/area/shuttle/personally_bought/do_it_yourself_large)
"Hq" = (
/obj/structure/cable,
/obj/machinery/atmospherics/pipe/smart/manifold4w/supply/hidden/layer4,
/obj/machinery/atmospherics/pipe/smart/manifold4w/scrubbers/hidden/layer2,
/obj/effect/turf_decal/delivery/white,
/obj/machinery/door/airlock/command,
/turf/open/floor/iron/dark/smooth_large,
/area/shuttle/personally_bought/do_it_yourself_large)
"HK" = (
/turf/closed/wall/mineral/titanium,
/area/shuttle/personally_bought/do_it_yourself_large)
"Ir" = (
/obj/effect/turf_decal/delivery,
/obj/structure/holosign/barrier/atmos/sturdy,
/obj/machinery/door/poddoor/preopen/personal_bay_two,
/turf/open/floor/iron/dark/smooth_large,
/area/shuttle/personally_bought/do_it_yourself_large)
"Iu" = (
/obj/machinery/atmospherics/pipe/smart/manifold4w/supply/hidden/layer4,
/obj/machinery/atmospherics/pipe/smart/manifold4w/scrubbers/hidden/layer2,
/turf/open/floor/iron/smooth,
/area/shuttle/personally_bought/do_it_yourself_large)
"JU" = (
/obj/structure/cable,
/obj/machinery/atmospherics/components/unary/vent_scrubber/on/layer2{
	dir = 8
	},
/turf/open/floor/plating,
/area/shuttle/personally_bought/do_it_yourself_large)
"KK" = (
/obj/machinery/light/cold/directional/west,
/turf/open/floor/plating,
/area/shuttle/personally_bought/do_it_yourself_large)
"Ln" = (
/obj/structure/closet/firecloset/shuttle,
/obj/effect/turf_decal/bot_white,
/turf/open/floor/iron/dark/smooth_large,
/area/shuttle/personally_bought/do_it_yourself_large)
"Lw" = (
/obj/machinery/atmospherics/components/unary/vent_pump/on/layer4{
	dir = 4
	},
/turf/open/floor/plating,
/area/shuttle/personally_bought/do_it_yourself_large)
"Ma" = (
/obj/structure/cable,
/turf/open/floor/plating,
/area/shuttle/personally_bought/do_it_yourself_large)
"Mo" = (
/turf/open/floor/plating,
/area/shuttle/personally_bought/do_it_yourself_large)
"MV" = (
/obj/effect/spawner/structure/window/reinforced/shuttle,
/obj/machinery/door/poddoor/preopen/personal_shuttle_windows,
/obj/structure/cable,
/turf/open/floor/plating,
/area/shuttle/personally_bought/do_it_yourself_large)
"NN" = (
/obj/machinery/button/door/personal_shuttle_bay_two/directional/south,
/obj/machinery/light/cold/directional/west,
/turf/open/floor/plating,
/area/shuttle/personally_bought/do_it_yourself_large)
"Ov" = (
/obj/effect/turf_decal/bot_white,
/obj/machinery/disposal/bin,
/obj/structure/disposalpipe/trunk{
	dir = 8
	},
/turf/open/floor/iron/dark/smooth_large,
/area/shuttle/personally_bought/do_it_yourself_large)
"OO" = (
/obj/machinery/airalarm/directional/north,
/obj/effect/mapping_helpers/airalarm/all_access,
/turf/open/floor/plating,
/area/shuttle/personally_bought/do_it_yourself_large)
"OZ" = (
/obj/structure/cable,
/obj/machinery/atmospherics/pipe/smart/manifold4w/supply/hidden/layer4,
/obj/machinery/atmospherics/pipe/smart/manifold4w/scrubbers/hidden/layer2,
/obj/machinery/airalarm/directional/east,
/obj/effect/mapping_helpers/airalarm/all_access,
/obj/machinery/light/cold/directional/east,
/obj/effect/landmark/ship_captain_spawner,
/turf/open/floor/plating,
/area/shuttle/personally_bought/do_it_yourself_large)
"Px" = (
/obj/machinery/atmospherics/components/unary/vent_scrubber/on/layer2{
	dir = 8
	},
/turf/open/floor/plating,
/area/shuttle/personally_bought/do_it_yourself_large)
"PD" = (
/obj/structure/extinguisher_cabinet/directional/east,
/turf/open/floor/plating,
/area/shuttle/personally_bought/do_it_yourself_large)
"PG" = (
/obj/machinery/airalarm/directional/west,
/obj/effect/mapping_helpers/airalarm/all_access,
/turf/open/floor/plating,
/area/shuttle/personally_bought/do_it_yourself_large)
"PH" = (
/obj/machinery/button/door/personal_shuttle_bay_two/directional/south,
/turf/open/floor/plating,
/area/shuttle/personally_bought/do_it_yourself_large)
"PT" = (
/obj/machinery/airalarm/directional/east,
/obj/effect/mapping_helpers/airalarm/all_access,
/turf/open/floor/plating,
/area/shuttle/personally_bought/do_it_yourself_large)
"SU" = (
/obj/structure/marker_beacon/burgundy,
/turf/closed/wall/mineral/titanium,
/area/shuttle/personally_bought/do_it_yourself_large)
"TE" = (
/obj/machinery/atmospherics/components/unary/vent_pump/on/layer4{
	dir = 4
	},
/obj/machinery/light/cold/directional/west,
/turf/open/floor/plating,
/area/shuttle/personally_bought/do_it_yourself_large)
"TM" = (
/obj/effect/spawner/structure/window/reinforced/shuttle,
/obj/machinery/door/poddoor/preopen/personal_shuttle_windows,
/obj/structure/cable,
/obj/structure/railing/eva_handhold/directional/north,
/turf/open/floor/plating,
/area/shuttle/personally_bought/do_it_yourself_large)
"Ur" = (
/obj/structure/marker_beacon/olive,
/turf/closed/wall/mineral/plastitanium,
/area/shuttle/personally_bought/do_it_yourself_large)
"UK" = (
/turf/closed/wall/mineral/plastitanium/nodiagonal,
/area/shuttle/personally_bought/do_it_yourself_large)
"VF" = (
/obj/item/radio/intercom/directional/south,
/obj/structure/chair/comfy/shuttle{
	dir = 1
	},
/obj/structure/cable,
/turf/open/floor/iron/smooth,
/area/shuttle/personally_bought/do_it_yourself_large)
"WO" = (
/obj/machinery/atmospherics/components/unary/vent_scrubber/on/layer2{
	dir = 1
	},
/turf/open/floor/plating,
/area/shuttle/personally_bought/do_it_yourself_large)
"Xe" = (
/obj/structure/cable,
/obj/machinery/atmospherics/pipe/smart/manifold4w/supply/hidden/layer4,
/obj/machinery/atmospherics/pipe/smart/manifold4w/scrubbers/hidden/layer2,
/obj/machinery/wall_healer/free/directional/east,
/turf/open/floor/plating,
/area/shuttle/personally_bought/do_it_yourself_large)
"XY" = (
/obj/effect/turf_decal/delivery/white,
/obj/machinery/door/airlock/external,
/obj/effect/mapping_helpers/airlock/cyclelink_helper,
/obj/docking_port/mobile/personally_bought{
	dir = 2;
	port_direction = 8
	},
/obj/structure/fans/tiny,
/turf/open/floor/iron/dark/smooth_large,
/area/shuttle/personally_bought/do_it_yourself_large)
"Yd" = (
/turf/closed/wall/mineral/titanium/nodiagonal,
/area/shuttle/personally_bought/do_it_yourself_large)
"YB" = (
/obj/machinery/digital_clock/directional/west,
/turf/open/floor/plating,
/area/shuttle/personally_bought/do_it_yourself_large)
"YG" = (
/obj/structure/cable,
/obj/structure/extinguisher_cabinet/directional/north,
/obj/machinery/light/cold/directional/north,
/turf/open/floor/plating,
/area/shuttle/personally_bought/do_it_yourself_large)
"Zu" = (
/obj/machinery/power/micro_reactor,
/obj/structure/cable,
/turf/open/floor/iron/dark/smooth_large,
/area/shuttle/personally_bought/do_it_yourself_large)
"ZL" = (
/obj/machinery/atmospherics/components/unary/vent_scrubber/on/layer2,
/turf/open/floor/plating,
/area/shuttle/personally_bought/do_it_yourself_large)
"ZM" = (
/obj/effect/turf_decal/delivery/white,
/obj/machinery/door/airlock/external,
/obj/effect/mapping_helpers/airlock/cyclelink_helper{
	dir = 1
	},
/obj/structure/fans/tiny,
/turf/open/floor/iron/dark/smooth_large,
/area/shuttle/personally_bought/do_it_yourself_large)

(1,1,1) = {"
xW
xW
xW
UK
hh
hh
hh
UK
xW
xW
xW
"}
(2,1,1) = {"
mb
cq
eL
UK
uF
uF
uF
UK
hh
hh
Ur
"}
(3,1,1) = {"
UK
Gp
hJ
UK
Mo
Zu
Mo
UK
uF
uF
UK
"}
(4,1,1) = {"
UK
Ov
Bb
Yd
in
Zu
qE
Yd
ql
Fc
UK
"}
(5,1,1) = {"
Yd
Er
Iu
hk
mY
Bu
mY
oA
Iu
eo
Yd
"}
(6,1,1) = {"
kA
Yd
Yd
Yd
Mo
Bu
Mo
Yd
tC
Ln
GD
"}
(7,1,1) = {"
MV
Ma
PG
Yd
Yd
na
Yd
Yd
Yd
Yd
DJ
"}
(8,1,1) = {"
Ae
YG
in
Mo
Yd
Bu
Mo
AT
Lw
Mo
GD
"}
(9,1,1) = {"
MV
Ma
Bu
Bu
CL
Bu
Bu
Eg
mY
Mo
Yd
"}
(10,1,1) = {"
TM
Mo
nJ
Mo
Yd
OO
Bu
tO
Px
Mo
GD
"}
(11,1,1) = {"
SU
Yd
MV
Yd
Yd
Yd
CL
Yd
Yd
Yd
je
"}
(12,1,1) = {"
xW
Yd
zH
KK
PG
YB
Bu
Mo
NN
Yd
xW
"}
(13,1,1) = {"
xW
FM
Mo
Mo
Mo
Mo
Bu
WO
Mo
Ir
xW
"}
(14,1,1) = {"
xW
FM
Mo
wU
Bu
Bu
Bu
Gs
Mo
Ir
xW
"}
(15,1,1) = {"
xW
FM
Mo
ZL
Bu
Mo
Ma
Mo
Mo
Ir
xW
"}
(16,1,1) = {"
xW
Yd
Bh
zJ
Bu
PD
Ma
Mo
bN
Yd
xW
"}
(17,1,1) = {"
SU
Yd
Yd
Yd
CL
Yd
MV
MV
Yd
Yd
je
"}
(18,1,1) = {"
Ae
sI
Yd
zC
Bu
Lw
in
PH
Yd
sI
GD
"}
(19,1,1) = {"
XY
pq
DD
Bu
Bu
OZ
Bu
mY
xh
pq
ZM
"}
(20,1,1) = {"
Ae
Yd
Yd
lk
Yd
Yd
lk
Yd
Yd
Yd
GD
"}
(21,1,1) = {"
Yd
cL
TE
Bu
Yd
Mo
Bu
KK
Lw
Mo
DJ
"}
(22,1,1) = {"
Ae
EY
Bu
Xe
lk
Bu
Bu
mY
mY
AW
GD
"}
(23,1,1) = {"
DJ
Yd
Hq
Yd
Yd
jT
Ma
Ma
JU
Ma
MV
"}
(24,1,1) = {"
Ae
uw
yK
cu
Yd
Mo
Mo
PT
Mo
Mo
GD
"}
(25,1,1) = {"
zo
nD
fm
rf
Yd
Yd
DJ
Yd
Yd
Yd
Yd
"}
(26,1,1) = {"
zo
yx
VF
Yd
HK
xW
xW
xW
xW
Yd
DJ
"}
(27,1,1) = {"
SU
Yd
tF
zo
xW
xW
xW
xW
xW
uT
sn
"}
(28,1,1) = {"
xW
HK
zo
Yd
xW
xW
xW
xW
xW
xW
xW
"}
