//MAP CONVERTED BY dmm2tgm.py THIS HEADER COMMENT PREVENTS RECONVERSION, DO NOT REMOVE
"bj" = (
/obj/structure/closet/firecloset/shuttle/tools,
/obj/machinery/light/blacklight/directional/east,
/turf/open/floor/plating/nanocarbon,
/area/shuttle/personally_bought/mining_hub)
"bN" = (
/obj/machinery/atmospherics/components/unary/vent_pump/on/layer4{
	dir = 4
	},
/turf/open/floor/plating/nanocarbon,
/area/shuttle/personally_bought/mining_hub)
"bT" = (
/obj/structure/shuttle_decoration/wall_plate/gold_foil,
/turf/closed/wall/mineral/aluminum,
/area/shuttle/personally_bought/mining_hub)
"cq" = (
/obj/structure/shuttle_decoration/wall_plate/armor{
	dir = 1
	},
/turf/closed/wall/mineral/nanocarbon/nodiagonal/black,
/area/shuttle/personally_bought/mining_hub)
"cu" = (
/obj/structure/shuttle_decoration/wall_plate/gold_foil{
	dir = 1
	},
/turf/closed/wall/mineral/nanocarbon/nodiagonal/black,
/area/shuttle/personally_bought/mining_hub)
"cL" = (
/obj/machinery/computer/shuttle/personally_bought,
/turf/open/floor/plating/nanocarbon,
/area/shuttle/personally_bought/mining_hub)
"cU" = (
/obj/structure/shuttle_decoration/wall_plate/gold_foil{
	dir = 1
	},
/turf/closed/wall/mineral/aluminum,
/area/shuttle/personally_bought/mining_hub)
"dj" = (
/obj/machinery/atmos_shield_gen/active{
	dir = 4
	},
/obj/machinery/door/poddoor/preopen/personal_bay_two,
/obj/machinery/button/door/personal_shuttle_bay_two/directional/west,
/turf/open/floor/plating/nanocarbon,
/area/shuttle/personally_bought/mining_hub)
"ds" = (
/obj/structure/table/reinforced,
/obj/machinery/recharger,
/obj/machinery/light/warm/directional/south,
/turf/open/floor/iron/dark/smooth_large,
/area/shuttle/personally_bought/mining_hub)
"eo" = (
/obj/structure/shuttle_decoration/eva_catwalks/directional/south,
/obj/structure/shuttle_decoration/wall_plate/gold_foil{
	dir = 1
	},
/turf/closed/wall/mineral/nanocarbon/nodiagonal/primary_colour,
/area/shuttle/personally_bought/mining_hub)
"eL" = (
/obj/structure/closet/firecloset/shuttle,
/turf/open/floor/plating/nanocarbon,
/area/shuttle/personally_bought/mining_hub)
"fm" = (
/obj/structure/shuttle_decoration/wall_plate/armor,
/turf/closed/wall/mineral/nanocarbon/nodiagonal/black,
/area/shuttle/personally_bought/mining_hub)
"hh" = (
/obj/machinery/power/shuttle_engine/propulsion{
	dir = 8
	},
/obj/structure/engine_covers/thruster_nozzle{
	dir = 8
	},
/turf/open/floor/plating/nanocarbon/airless,
/area/shuttle/personally_bought/mining_hub)
"hk" = (
/obj/structure/cable,
/obj/machinery/atmospherics/pipe/smart/manifold4w/scrubbers/hidden/layer2,
/obj/structure/mineral_door/manual_colony_door/shuttle/interior,
/turf/open/floor/plating/nanocarbon,
/area/shuttle/personally_bought/mining_hub)
"hJ" = (
/obj/machinery/power/shuttle_engine/heater{
	dir = 8
	},
/obj/structure/engine_covers/heater_cover{
	dir = 4
	},
/turf/open/floor/plating/nanocarbon/airless,
/area/shuttle/personally_bought/mining_hub)
"hP" = (
/obj/structure/cable,
/obj/machinery/atmospherics/pipe/smart/manifold4w/supply/hidden/layer4,
/obj/machinery/atmospherics/pipe/smart/manifold4w/scrubbers/hidden/layer2,
/obj/machinery/wall_healer/free/directional/south,
/turf/open/floor/plating/nanocarbon,
/area/shuttle/personally_bought/mining_hub)
"in" = (
/obj/machinery/atmospherics/components/unary/vent_scrubber/on/layer2{
	dir = 4
	},
/obj/machinery/computer/monitor,
/obj/structure/cable,
/turf/open/floor/plating/nanocarbon,
/area/shuttle/personally_bought/mining_hub)
"iX" = (
/obj/machinery/atmospherics/pipe/smart/manifold4w/supply/hidden/layer4,
/obj/machinery/atmospherics/pipe/smart/manifold4w/scrubbers/hidden/layer2,
/turf/open/floor/catwalk_floor/colony_fabricator/nanocarbon,
/area/shuttle/personally_bought/mining_hub)
"je" = (
/obj/structure/shuttle_decoration/headlight/directional/south,
/turf/closed/wall/mineral/nanocarbon/nodiagonal/primary_colour,
/area/shuttle/personally_bought/mining_hub)
"jT" = (
/obj/machinery/atmospherics/pipe/smart/manifold4w/supply/hidden/layer4,
/obj/machinery/atmospherics/pipe/smart/manifold4w/scrubbers/hidden/layer2,
/obj/effect/mapping_helpers/airlock/cyclelink_helper,
/obj/machinery/door/airlock/spacer,
/turf/open/floor/plating/nanocarbon,
/area/shuttle/personally_bought/mining_hub)
"kA" = (
/obj/structure/shuttle_decoration/wall_plate/gold_foil,
/turf/closed/wall/mineral/nanocarbon/nodiagonal/black,
/area/shuttle/personally_bought/mining_hub)
"lk" = (
/obj/structure/shuttle_decoration/bullbar/directional/east,
/obj/structure/shuttle_decoration/headlight/directional/east,
/obj/structure/shuttle_decoration/eva_catwalks/directional/east,
/turf/closed/wall/mineral/nanocarbon/nodiagonal/primary_colour,
/area/shuttle/personally_bought/mining_hub)
"mb" = (
/obj/structure/cable,
/obj/machinery/atmospherics/pipe/smart/manifold4w/supply/hidden/layer4,
/obj/machinery/atmospherics/pipe/smart/manifold4w/scrubbers/hidden/layer2,
/obj/machinery/airalarm/directional/east,
/obj/effect/mapping_helpers/airalarm/all_access,
/obj/machinery/light/cold/directional/east,
/obj/effect/landmark/ship_captain_spawner,
/turf/open/floor/plating/nanocarbon,
/area/shuttle/personally_bought/mining_hub)
"mY" = (
/obj/machinery/atmospherics/pipe/smart/manifold4w/scrubbers/hidden/layer2,
/turf/open/floor/iron/colony/nanocarbon,
/area/shuttle/personally_bought/mining_hub)
"na" = (
/obj/machinery/atmospherics/pipe/smart/manifold4w/supply/hidden/layer4,
/obj/machinery/atmospherics/pipe/smart/manifold4w/scrubbers/hidden/layer2,
/obj/structure/cable,
/obj/structure/mineral_door/manual_colony_door/shuttle/interior,
/turf/open/floor/plating/nanocarbon,
/area/shuttle/personally_bought/mining_hub)
"ng" = (
/obj/structure/tank_dispenser,
/turf/open/floor/plating/nanocarbon,
/area/shuttle/personally_bought/mining_hub)
"nD" = (
/obj/machinery/recharge_station,
/obj/machinery/atmospherics/components/unary/vent_scrubber/on/layer2,
/turf/open/floor/plating/nanocarbon,
/area/shuttle/personally_bought/mining_hub)
"nJ" = (
/turf/open/floor/plating/aluminum,
/area/shuttle/personally_bought/mining_hub)
"oA" = (
/obj/structure/cable,
/obj/machinery/atmospherics/pipe/smart/manifold4w/supply/hidden/layer4,
/obj/structure/mineral_door/manual_colony_door/shuttle/interior,
/turf/open/floor/plating/nanocarbon,
/area/shuttle/personally_bought/mining_hub)
"pq" = (
/obj/item/storage/toolbox/emergency,
/obj/item/binoculars,
/obj/item/trench_tool,
/obj/structure/secure_safe/directional/north,
/obj/structure/extinguisher_cabinet/directional/west,
/obj/structure/shelf,
/turf/open/floor/plating/nanocarbon,
/area/shuttle/personally_bought/mining_hub)
"ql" = (
/obj/machinery/portable_atmospherics/canister/air,
/obj/machinery/atmospherics/components/unary/portables_connector/visible/layer4{
	dir = 4
	},
/turf/open/floor/plating/nanocarbon,
/area/shuttle/personally_bought/mining_hub)
"qE" = (
/obj/machinery/atmospherics/components/unary/vent_pump/on/layer4{
	dir = 4
	},
/obj/effect/spawner/random/engineering/canister,
/obj/machinery/airalarm/directional/south,
/obj/effect/mapping_helpers/airalarm/all_access,
/turf/open/floor/plating/nanocarbon,
/area/shuttle/personally_bought/mining_hub)
"rf" = (
/obj/structure/mineral_door/manual_colony_door/shuttle/interior,
/obj/machinery/atmospherics/pipe/smart/manifold4w/supply/hidden/layer4,
/obj/machinery/atmospherics/pipe/smart/manifold4w/scrubbers/hidden/layer2,
/obj/structure/cable,
/turf/open/floor/plating/nanocarbon,
/area/shuttle/personally_bought/mining_hub)
"sn" = (
/obj/machinery/holopad,
/obj/machinery/button/door/personal_shuttle_windows/directional/north,
/turf/open/floor/plating/nanocarbon,
/area/shuttle/personally_bought/mining_hub)
"sI" = (
/obj/structure/extinguisher_cabinet/directional/north,
/obj/machinery/recharge_station,
/obj/machinery/light/red/directional/north,
/obj/machinery/atmospherics/pipe/smart/manifold4w/scrubbers/hidden/layer2,
/turf/open/floor/plating/nanocarbon,
/area/shuttle/personally_bought/mining_hub)
"tC" = (
/obj/structure/shuttle_decoration/wall_plate/gold_foil{
	dir = 8
	},
/obj/structure/shuttle_decoration/wall_plate/armor{
	dir = 4
	},
/turf/closed/wall/mineral/aluminum,
/area/shuttle/personally_bought/mining_hub)
"tF" = (
/obj/structure/shuttle_decoration/wall_plate/gold_foil{
	dir = 8
	},
/turf/closed/wall/mineral/aluminum,
/area/shuttle/personally_bought/mining_hub)
"tO" = (
/obj/machinery/atmospherics/components/unary/vent_scrubber/on/layer2{
	dir = 8
	},
/turf/open/floor/plating/nanocarbon,
/area/shuttle/personally_bought/mining_hub)
"uw" = (
/obj/structure/shuttle_decoration/wall_plate/armor{
	dir = 8
	},
/obj/structure/shuttle_decoration/wall_plate/plastamic{
	dir = 4
	},
/turf/closed/wall/mineral/aluminum,
/area/shuttle/personally_bought/mining_hub)
"uF" = (
/obj/structure/shuttle_decoration/wall_plate/armor,
/obj/structure/shuttle_decoration/eva_catwalks/directional/south,
/turf/closed/wall/mineral/nanocarbon/nodiagonal/black,
/area/shuttle/personally_bought/mining_hub)
"uT" = (
/obj/structure/window/fulltile/salvage_shuttle,
/obj/machinery/door/poddoor/preopen/personal_shuttle_windows,
/turf/open/floor/plating/nanocarbon,
/area/shuttle/personally_bought/mining_hub)
"vX" = (
/obj/machinery/atmospherics/components/unary/vent_pump/on/layer4{
	dir = 4
	},
/obj/machinery/light/red/directional/south,
/obj/machinery/button/door/personal_shuttle_bay_one/directional/west,
/turf/open/floor/plating/nanocarbon,
/area/shuttle/personally_bought/mining_hub)
"wU" = (
/obj/structure/cable,
/obj/machinery/atmospherics/pipe/smart/manifold4w/supply/hidden/layer4,
/obj/machinery/atmospherics/pipe/smart/manifold4w/scrubbers/hidden/layer2,
/turf/open/floor/plating/nanocarbon,
/area/shuttle/personally_bought/mining_hub)
"xh" = (
/obj/structure/shuttle_decoration/radiator/directional/south,
/turf/closed/wall/mineral/nanocarbon/nodiagonal/black,
/area/shuttle/personally_bought/mining_hub)
"xW" = (
/turf/template_noop,
/area/template_noop)
"xX" = (
/obj/structure/shuttle_decoration/wall_plate/plastamic{
	dir = 8
	},
/turf/closed/wall/mineral/aluminum,
/area/shuttle/personally_bought/mining_hub)
"yx" = (
/obj/structure/shuttle_decoration/bullbar/directional/east,
/obj/structure/shuttle_decoration/eva_catwalks/directional/east,
/turf/closed/wall/mineral/nanocarbon/nodiagonal/primary_colour,
/area/shuttle/personally_bought/mining_hub)
"yK" = (
/obj/structure/extinguisher_cabinet/directional/west,
/obj/machinery/recharge_station,
/obj/effect/turf_decal/bot_white,
/turf/open/floor/plating/nanocarbon,
/area/shuttle/personally_bought/mining_hub)
"zo" = (
/obj/machinery/computer/camera_advanced/shuttle_docker/personally_bought{
	x_offset = -5;
	y_offset = -5;
	view_range = 4
	},
/turf/open/floor/plating/nanocarbon,
/area/shuttle/personally_bought/mining_hub)
"zC" = (
/turf/closed/wall/mineral/aluminum,
/area/shuttle/personally_bought/mining_hub)
"zH" = (
/obj/structure/shuttle_decoration/wall_plate/armor{
	dir = 8
	},
/turf/closed/wall/mineral/aluminum,
/area/shuttle/personally_bought/mining_hub)
"zJ" = (
/obj/structure/cable,
/obj/machinery/atmospherics/pipe/smart/manifold4w/supply/hidden/layer4,
/obj/machinery/atmospherics/pipe/smart/manifold4w/scrubbers/hidden/layer2,
/obj/machinery/vending/wallmed/directional/south,
/turf/open/floor/plating/nanocarbon,
/area/shuttle/personally_bought/mining_hub)
"Ae" = (
/turf/closed/wall/mineral/nanocarbon/nodiagonal/primary_colour,
/area/shuttle/personally_bought/mining_hub)
"AT" = (
/obj/machinery/atmospherics/components/unary/vent_pump/on/layer4{
	dir = 4
	},
/obj/machinery/light/red/directional/north,
/obj/machinery/button/door/personal_shuttle_bay_two/directional/west,
/turf/open/floor/plating/nanocarbon,
/area/shuttle/personally_bought/mining_hub)
"AW" = (
/obj/machinery/exoscanner/shuttle_part/radio_dish/directional/east,
/turf/closed/wall/mineral/nanocarbon/nodiagonal/secondary_colour,
/area/shuttle/personally_bought/mining_hub)
"Bb" = (
/obj/machinery/portable_atmospherics/canister,
/obj/machinery/atmospherics/components/unary/portables_connector/visible/layer2{
	dir = 4
	},
/turf/open/floor/plating/nanocarbon,
/area/shuttle/personally_bought/mining_hub)
"Bh" = (
/obj/machinery/atmospherics/components/unary/vent_pump/on/layer4{
	dir = 4
	},
/obj/machinery/light/cold/directional/west,
/obj/structure/tank_dispenser,
/turf/open/floor/plating/nanocarbon,
/area/shuttle/personally_bought/mining_hub)
"Bu" = (
/obj/structure/cable,
/obj/machinery/atmospherics/pipe/smart/manifold4w/supply/hidden/layer4,
/obj/machinery/atmospherics/pipe/smart/manifold4w/scrubbers/hidden/layer2,
/turf/open/floor/catwalk_floor/colony_fabricator/nanocarbon,
/area/shuttle/personally_bought/mining_hub)
"CL" = (
/obj/machinery/atmospherics/pipe/smart/manifold4w/scrubbers/hidden/layer2,
/obj/machinery/atmospherics/pipe/smart/manifold4w/supply/hidden/layer4,
/obj/structure/mineral_door/manual_colony_door/shuttle,
/turf/open/floor/plating/nanocarbon,
/area/shuttle/personally_bought/mining_hub)
"DD" = (
/obj/structure/cable,
/obj/machinery/atmospherics/pipe/smart/manifold4w/scrubbers/hidden/layer2,
/obj/machinery/atmospherics/components/unary/vent_pump/on/layer4{
	dir = 8
	},
/turf/open/floor/plating/nanocarbon,
/area/shuttle/personally_bought/mining_hub)
"DJ" = (
/turf/closed/wall/mineral/nanocarbon/nodiagonal/secondary_colour,
/area/shuttle/personally_bought/mining_hub)
"Eg" = (
/obj/machinery/atmospherics/pipe/smart/manifold4w/scrubbers/hidden/layer2,
/obj/machinery/atmospherics/pipe/smart/manifold4w/supply/hidden/layer4,
/turf/open/floor/plating/nanocarbon,
/area/shuttle/personally_bought/mining_hub)
"Er" = (
/obj/structure/shuttle_decoration/eva_catwalks/directional/north,
/turf/closed/wall/mineral/nanocarbon/nodiagonal/primary_colour,
/area/shuttle/personally_bought/mining_hub)
"EY" = (
/obj/machinery/atmospherics/components/unary/vent_scrubber/on/layer2{
	dir = 4
	},
/turf/open/floor/plating/nanocarbon,
/area/shuttle/personally_bought/mining_hub)
"Fc" = (
/obj/structure/shuttle_decoration/extinguisher/directional/south,
/obj/structure/shuttle_decoration/eva_catwalks/directional/south,
/obj/structure/shuttle_decoration/wall_plate/gold_foil{
	dir = 1
	},
/turf/closed/wall/mineral/nanocarbon/nodiagonal/black,
/area/shuttle/personally_bought/mining_hub)
"FM" = (
/obj/structure/shuttle_decoration/wall_plate/armor,
/obj/structure/shuttle_decoration/wall_plate/armor{
	dir = 1
	},
/turf/closed/wall/mineral/aluminum,
/area/shuttle/personally_bought/mining_hub)
"Gp" = (
/obj/structure/shuttle_decoration/wall_plate/armor{
	dir = 1
	},
/obj/structure/shuttle_decoration/eva_catwalks/directional/north,
/turf/closed/wall/mineral/nanocarbon/nodiagonal/black,
/area/shuttle/personally_bought/mining_hub)
"Gs" = (
/obj/structure/shuttle_decoration/extinguisher/directional/north,
/turf/closed/wall/mineral/aluminum,
/area/shuttle/personally_bought/mining_hub)
"GD" = (
/obj/machinery/atmos_shield_gen/active{
	dir = 8
	},
/obj/machinery/door/poddoor/preopen/personal_bay_two,
/obj/machinery/button/door/personal_shuttle_bay_two/directional/east,
/turf/open/floor/plating/nanocarbon,
/area/shuttle/personally_bought/mining_hub)
"Hq" = (
/obj/machinery/door/poddoor/preopen/personal_shuttle_windows,
/obj/structure/window/fulltile/salvage_shuttle,
/turf/open/floor/plating/nanocarbon,
/area/shuttle/personally_bought/mining_hub)
"HK" = (
/obj/machinery/suit_storage_unit/industrial/personal_shuttle,
/turf/open/floor/plating/nanocarbon,
/area/shuttle/personally_bought/mining_hub)
"Ir" = (
/obj/machinery/portable_atmospherics/canister/oxygen,
/obj/machinery/atmospherics/components/unary/vent_scrubber/on/layer2{
	dir = 4
	},
/obj/machinery/light/red/dim/directional/west,
/turf/open/floor/plating/nanocarbon,
/area/shuttle/personally_bought/mining_hub)
"Iu" = (
/obj/machinery/atmospherics/pipe/smart/manifold4w/supply/hidden/layer4,
/obj/machinery/light/red/directional/south,
/turf/open/floor/plating/nanocarbon,
/area/shuttle/personally_bought/mining_hub)
"JU" = (
/obj/machinery/digital_clock/directional/south,
/turf/open/floor/plating/nanocarbon,
/area/shuttle/personally_bought/mining_hub)
"KK" = (
/obj/machinery/modular_computer/preset/engineering{
	dir = 1
	},
/obj/structure/cable,
/obj/machinery/digital_clock/directional/south,
/turf/open/floor/plating/nanocarbon,
/area/shuttle/personally_bought/mining_hub)
"Ln" = (
/obj/structure/shuttle_decoration/ladder_black/directional/north,
/turf/closed/wall/mineral/nanocarbon/nodiagonal/secondary_colour,
/area/shuttle/personally_bought/mining_hub)
"Lw" = (
/obj/structure/closet/crate/cardboard/mothic,
/obj/item/construction/rtd/loaded{
	pixel_y = 7
	},
/obj/item/airlock_painter{
	pixel_y = -7
	},
/obj/item/airlock_painter/decal,
/obj/item/rcd_ammo,
/obj/structure/extinguisher_cabinet/directional/north,
/turf/open/floor/plating/nanocarbon,
/area/shuttle/personally_bought/mining_hub)
"Ma" = (
/obj/machinery/atmospherics/pipe/smart/manifold4w/supply/hidden/layer4,
/obj/machinery/atmospherics/pipe/smart/manifold4w/scrubbers/hidden/layer2,
/turf/open/floor/plating/nanocarbon,
/area/shuttle/personally_bought/mining_hub)
"Mo" = (
/obj/structure/shuttle_decoration/junction_box/directional/east,
/turf/closed/wall/mineral/aluminum,
/area/shuttle/personally_bought/mining_hub)
"MV" = (
/obj/machinery/door/poddoor/preopen/personal_bay_one,
/turf/open/floor/plating/nanocarbon,
/area/shuttle/personally_bought/mining_hub)
"NN" = (
/turf/closed/wall/mineral/nanocarbon/nodiagonal/black,
/area/shuttle/personally_bought/mining_hub)
"Od" = (
/turf/closed/wall/mineral/nanocarbon/secondary_colour,
/area/shuttle/personally_bought/mining_hub)
"Ov" = (
/obj/structure/shuttle_decoration/extinguisher/directional/north,
/obj/structure/shuttle_decoration/eva_catwalks/directional/north,
/obj/structure/shuttle_decoration/wall_plate/gold_foil,
/turf/closed/wall/mineral/nanocarbon/nodiagonal/black,
/area/shuttle/personally_bought/mining_hub)
"OO" = (
/obj/machinery/atmospherics/pipe/smart/manifold4w/supply/hidden/layer4,
/obj/machinery/atmospherics/pipe/smart/manifold4w/scrubbers/hidden/layer2,
/obj/structure/cable,
/turf/open/floor/plating/nanocarbon,
/area/shuttle/personally_bought/mining_hub)
"OZ" = (
/obj/machinery/light/warm/directional/east,
/turf/open/floor/plating/nanocarbon,
/area/shuttle/personally_bought/mining_hub)
"Px" = (
/obj/machinery/light/cold/directional/west,
/turf/open/floor/plating/nanocarbon,
/area/shuttle/personally_bought/mining_hub)
"PD" = (
/obj/machinery/atmospherics/pipe/smart/manifold4w/supply/hidden/layer4,
/obj/machinery/atmospherics/pipe/smart/manifold4w/scrubbers/hidden/layer2,
/obj/structure/mineral_door/manual_colony_door/shuttle/interior,
/turf/open/floor/plating/nanocarbon,
/area/shuttle/personally_bought/mining_hub)
"PG" = (
/turf/open/floor/plating/nanocarbon,
/area/shuttle/personally_bought/mining_hub)
"PH" = (
/obj/structure/shuttle_decoration/extinguisher/directional/south,
/turf/closed/wall/mineral/aluminum,
/area/shuttle/personally_bought/mining_hub)
"PT" = (
/obj/machinery/door/poddoor/preopen/personal_bay_two,
/turf/open/floor/plating/nanocarbon,
/area/shuttle/personally_bought/mining_hub)
"RX" = (
/obj/effect/mapping_helpers/airlock/cyclelink_helper{
	dir = 1
	},
/obj/structure/fans/tiny,
/obj/machinery/door/airlock/spacer,
/turf/open/floor/plating/nanocarbon,
/area/shuttle/personally_bought/mining_hub)
"SU" = (
/obj/structure/shuttle_decoration/headlight/directional/north,
/turf/closed/wall/mineral/nanocarbon/nodiagonal/primary_colour,
/area/shuttle/personally_bought/mining_hub)
"Tl" = (
/obj/machinery/modular_computer/preset/engineering,
/obj/structure/cable,
/turf/open/floor/plating/nanocarbon,
/area/shuttle/personally_bought/mining_hub)
"TE" = (
/obj/item/radio/intercom/directional/south,
/obj/structure/chair/comfy/shuttle{
	dir = 1
	},
/turf/open/floor/plating/nanocarbon,
/area/shuttle/personally_bought/mining_hub)
"TH" = (
/obj/structure/shuttle_decoration/ladder_black/directional/south,
/turf/closed/wall/mineral/nanocarbon/nodiagonal/secondary_colour,
/area/shuttle/personally_bought/mining_hub)
"TM" = (
/obj/machinery/atmos_shield_gen/active{
	dir = 8
	},
/obj/machinery/door/poddoor/preopen/personal_bay_one,
/obj/machinery/button/door/personal_shuttle_bay_one/directional/east,
/turf/open/floor/plating/nanocarbon,
/area/shuttle/personally_bought/mining_hub)
"Ue" = (
/obj/effect/mapping_helpers/airlock/cyclelink_helper,
/obj/docking_port/mobile/personally_bought{
	dir = 2;
	port_direction = 8
	},
/obj/structure/fans/tiny,
/obj/machinery/door/airlock/spacer,
/turf/open/floor/plating/nanocarbon,
/area/shuttle/personally_bought/mining_hub)
"Ur" = (
/obj/effect/mapping_helpers/airlock/cyclelink_helper{
	dir = 1
	},
/obj/machinery/atmospherics/pipe/smart/manifold4w/supply/hidden/layer4,
/obj/machinery/door/airlock/spacer,
/turf/open/floor/plating/nanocarbon,
/area/shuttle/personally_bought/mining_hub)
"UA" = (
/obj/structure/shuttle_decoration/junction_box/directional/west,
/turf/closed/wall/mineral/aluminum,
/area/shuttle/personally_bought/mining_hub)
"UK" = (
/obj/structure/shuttle_decoration/radiator/directional/north,
/turf/closed/wall/mineral/nanocarbon/nodiagonal/black,
/area/shuttle/personally_bought/mining_hub)
"VF" = (
/turf/closed/wall/mineral/nanocarbon/primary_colour,
/area/shuttle/personally_bought/mining_hub)
"VV" = (
/obj/machinery/airalarm/directional/east,
/obj/effect/mapping_helpers/airalarm/all_access,
/turf/open/floor/plating/nanocarbon,
/area/shuttle/personally_bought/mining_hub)
"We" = (
/obj/machinery/atmos_shield_gen/active{
	dir = 4
	},
/obj/machinery/door/poddoor/preopen/personal_bay_one,
/obj/machinery/button/door/personal_shuttle_bay_one/directional/west,
/turf/open/floor/plating/nanocarbon,
/area/shuttle/personally_bought/mining_hub)
"WO" = (
/obj/structure/closet/emcloset,
/turf/open/floor/plating/nanocarbon,
/area/shuttle/personally_bought/mining_hub)
"Xe" = (
/obj/structure/shuttle_decoration/eva_catwalks/directional/east,
/turf/closed/wall/mineral/nanocarbon/nodiagonal/primary_colour,
/area/shuttle/personally_bought/mining_hub)
"XY" = (
/obj/structure/shuttle_decoration/rcs/directional/north,
/turf/closed/wall/mineral/nanocarbon/nodiagonal/primary_colour,
/area/shuttle/personally_bought/mining_hub)
"Yd" = (
/obj/structure/shuttle_decoration/wall_plate/armor{
	dir = 4
	},
/turf/closed/wall/mineral/nanocarbon/nodiagonal/primary_colour,
/area/shuttle/personally_bought/mining_hub)
"YB" = (
/obj/structure/shuttle_decoration/bullbar/directional/east,
/obj/structure/shuttle_decoration/headlight/directional/east,
/turf/closed/wall/mineral/nanocarbon/nodiagonal/primary_colour,
/area/shuttle/personally_bought/mining_hub)
"YG" = (
/obj/machinery/atmospherics/pipe/smart/manifold4w/supply/hidden/layer4,
/turf/open/floor/iron/colony/nanocarbon,
/area/shuttle/personally_bought/mining_hub)
"Zu" = (
/obj/machinery/power/micro_reactor,
/obj/structure/cable,
/turf/open/floor/plating/nanocarbon,
/area/shuttle/personally_bought/mining_hub)
"ZL" = (
/obj/structure/cable,
/obj/machinery/atmospherics/pipe/smart/manifold4w/supply/hidden/layer4,
/obj/machinery/atmospherics/pipe/smart/manifold4w/scrubbers/hidden/layer2,
/obj/structure/mineral_door/manual_colony_door/shuttle/interior,
/turf/open/floor/plating/nanocarbon,
/area/shuttle/personally_bought/mining_hub)
"ZM" = (
/obj/structure/shuttle_decoration/rcs/directional/south,
/turf/closed/wall/mineral/nanocarbon/nodiagonal/primary_colour,
/area/shuttle/personally_bought/mining_hub)

(1,1,1) = {"
xW
FM
xW
UK
hh
hh
hh
xh
xW
FM
xW
"}
(2,1,1) = {"
xW
cq
hh
NN
hJ
hJ
hJ
NN
hh
fm
xW
"}
(3,1,1) = {"
xW
Gp
hJ
kA
Tl
Zu
ng
cu
hJ
uF
xW
"}
(4,1,1) = {"
xW
Ov
Bb
bT
in
Zu
qE
zC
ql
Fc
xW
"}
(5,1,1) = {"
xW
Er
sI
hk
mY
Bu
YG
oA
Iu
eo
xW
"}
(6,1,1) = {"
XY
Yd
tC
bT
eL
Bu
bj
cU
tC
Yd
ZM
"}
(7,1,1) = {"
SU
nJ
nJ
zC
UA
na
tF
zC
nJ
nJ
je
"}
(8,1,1) = {"
We
nJ
nJ
vX
PH
OO
Gs
AT
nJ
nJ
dj
"}
(9,1,1) = {"
MV
PG
PG
Eg
CL
OO
CL
Eg
PG
PG
PT
"}
(10,1,1) = {"
TM
nJ
nJ
tO
uT
OO
uT
tO
nJ
nJ
GD
"}
(11,1,1) = {"
SU
nJ
nJ
zC
zC
rf
zC
zC
nJ
nJ
je
"}
(12,1,1) = {"
DJ
uw
zH
zC
PG
OO
PG
zC
zH
uw
DJ
"}
(13,1,1) = {"
Ln
Ir
zC
yK
bN
OO
EY
WO
zC
Ir
TH
"}
(14,1,1) = {"
Ue
iX
Ur
wU
wU
mb
Ma
Ma
jT
iX
RX
"}
(15,1,1) = {"
Ln
xX
zC
ZL
zC
zC
PD
UA
Mo
xX
TH
"}
(16,1,1) = {"
DJ
HK
Bh
zJ
zC
PG
Ma
Px
bN
PG
DJ
"}
(17,1,1) = {"
Ae
nD
wU
hP
zC
PG
Eg
Ma
Ma
JU
Ae
"}
(18,1,1) = {"
Ae
zC
ZL
zC
zC
Lw
PG
PG
tO
PG
Hq
"}
(19,1,1) = {"
XY
pq
DD
KK
zC
OZ
PG
VV
PG
PG
ZM
"}
(20,1,1) = {"
Hq
zo
tO
ds
Ae
Xe
lk
yx
Xe
Ae
Ae
"}
(21,1,1) = {"
Hq
cL
TE
Ae
VF
xW
xW
xW
xW
DJ
DJ
"}
(22,1,1) = {"
VF
Ae
sn
Hq
xW
xW
xW
xW
xW
AW
Od
"}
(23,1,1) = {"
xW
VF
Hq
YB
xW
xW
xW
xW
xW
xW
xW
"}
