//MAP CONVERTED BY dmm2tgm.py THIS HEADER COMMENT PREVENTS RECONVERSION, DO NOT REMOVE
"am" = (
/obj/effect/spawner/random/engineering/atmospherics_portable,
/turf/open/floor/plating/aluminum,
/area/shuttle/personally_bought/private_liner)
"bf" = (
/obj/machinery/modular_computer/preset/engineering{
	dir = 4
	},
/obj/structure/cable,
/turf/open/floor/plating/nanocarbon,
/area/shuttle/personally_bought/private_liner)
"bg" = (
/turf/open/floor/catwalk_floor/colony_fabricator/nanocarbon,
/area/shuttle/personally_bought/private_liner)
"bl" = (
/obj/structure/shuttle_decoration/bullbar/directional/south,
/turf/closed/wall/mineral/nanocarbon/nodiagonal/secondary_colour,
/area/shuttle/personally_bought/private_liner)
"bQ" = (
/obj/effect/spawner/random/salvage/container_or_crate_or_cargo/civilian_supply,
/obj/structure/extinguisher_cabinet/directional/east,
/turf/open/floor/plating/aluminum,
/area/shuttle/personally_bought/private_liner)
"bU" = (
/obj/structure/closet/sleeping_compartment,
/turf/open/floor/plating/nanocarbon,
/area/shuttle/personally_bought/private_liner)
"cG" = (
/obj/effect/landmark/ship_captain_spawner,
/obj/machinery/atmospherics/pipe/smart/manifold4w/supply/hidden/layer4,
/obj/machinery/atmospherics/pipe/smart/manifold4w/scrubbers/hidden/layer2,
/turf/open/floor/catwalk_floor/colony_fabricator/nanocarbon,
/area/shuttle/personally_bought/private_liner)
"cH" = (
/obj/structure/shuttle_decoration/bullbar/directional/north,
/turf/closed/wall/mineral/nanocarbon/nodiagonal/primary_colour,
/area/shuttle/personally_bought/private_liner)
"cP" = (
/obj/structure/shuttle_decoration/junction_box/directional/south,
/obj/structure/shuttle_decoration/wall_plate/nanocarbon/secondary_colour{
	dir = 1
	},
/turf/closed/wall/mineral/nanocarbon/nodiagonal/secondary_colour,
/area/shuttle/personally_bought/private_liner)
"dc" = (
/obj/structure/window/fulltile/salvage_shuttle,
/obj/machinery/door/poddoor/preopen/personal_shuttle_windows,
/turf/open/floor/plating/nanocarbon,
/area/shuttle/personally_bought/private_liner)
"ea" = (
/obj/structure/shuttle_decoration/radiator/directional/south,
/turf/closed/wall/mineral/nanocarbon/nodiagonal/black,
/area/shuttle/personally_bought/private_liner)
"eb" = (
/obj/machinery/wall_healer/free/directional/south,
/obj/machinery/light/warm/directional/south,
/obj/machinery/atmospherics/pipe/smart/manifold4w/supply/hidden/layer4,
/obj/machinery/atmospherics/pipe/smart/manifold4w/scrubbers/hidden/layer2,
/obj/structure/cable,
/turf/open/floor/catwalk_floor/colony_fabricator/nanocarbon,
/area/shuttle/personally_bought/private_liner)
"fb" = (
/obj/machinery/suit_storage_unit/industrial/personal_shuttle,
/obj/machinery/atmospherics/pipe/smart/manifold4w/supply/hidden/layer4,
/turf/open/floor/plating/nanocarbon,
/area/shuttle/personally_bought/private_liner)
"fh" = (
/obj/effect/spawner/random/salvage/crate_only/civilian_supply,
/turf/open/floor/plating/nanocarbon,
/area/shuttle/personally_bought/private_liner)
"fG" = (
/obj/machinery/suit_storage_unit/industrial/personal_shuttle,
/turf/open/floor/plating/aluminum,
/area/shuttle/personally_bought/private_liner)
"hm" = (
/obj/machinery/atmospherics/pipe/smart/manifold4w/supply/hidden/layer4,
/obj/machinery/atmospherics/pipe/smart/manifold4w/scrubbers/hidden/layer2,
/obj/structure/mineral_door/manual_colony_door/shuttle,
/turf/open/floor/plating/nanocarbon,
/area/shuttle/personally_bought/private_liner)
"hy" = (
/obj/machinery/recharge_station,
/turf/open/floor/plating/nanocarbon,
/area/shuttle/personally_bought/private_liner)
"ic" = (
/obj/effect/turf_decal/stripes/white/line{
	dir = 4
	},
/turf/open/floor/plating/nanocarbon/exterior/black,
/area/shuttle/personally_bought/private_liner)
"ig" = (
/obj/structure/shuttle_decoration/wall_plate/armor{
	dir = 1
	},
/turf/closed/wall/mineral/nanocarbon/nodiagonal/black,
/area/shuttle/personally_bought/private_liner)
"iB" = (
/obj/structure/shelf,
/obj/item/storage/toolbox/emergency,
/obj/item/binoculars,
/obj/item/trench_tool,
/obj/machinery/button/door/personal_shuttle_windows/directional/north,
/obj/structure/secure_safe/directional/west,
/turf/open/floor/plating/nanocarbon,
/area/shuttle/personally_bought/private_liner)
"jj" = (
/obj/effect/spawner/random/salvage/container_or_crate_or_cargo/civilian_supply,
/obj/machinery/light/red/directional/north,
/turf/open/floor/plating/aluminum,
/area/shuttle/personally_bought/private_liner)
"km" = (
/obj/structure/shuttle_decoration/rcs/directional/north,
/turf/closed/wall/mineral/nanocarbon/nodiagonal/secondary_colour,
/area/shuttle/personally_bought/private_liner)
"kS" = (
/obj/structure/shuttle_decoration/extinguisher/directional/south,
/obj/structure/shuttle_decoration/wall_plate/gold_foil{
	dir = 1
	},
/turf/closed/wall/mineral/nanocarbon/nodiagonal/primary_colour,
/area/shuttle/personally_bought/private_liner)
"la" = (
/obj/structure/shuttle_decoration/wall_plate/plastamic{
	dir = 8
	},
/turf/closed/wall/mineral/aluminum,
/area/shuttle/personally_bought/private_liner)
"mP" = (
/obj/structure/chair/comfy/shuttle{
	dir = 4
	},
/obj/machinery/atmospherics/components/unary/vent_scrubber/on/layer2,
/turf/open/floor/iron/colony/white/texture/nanocarbon,
/area/shuttle/personally_bought/private_liner)
"nC" = (
/obj/machinery/atmospherics/pipe/smart/manifold4w/supply/hidden/layer4,
/obj/machinery/atmospherics/pipe/smart/manifold4w/scrubbers/hidden/layer2,
/turf/open/floor/iron/colony/nanocarbon,
/area/shuttle/personally_bought/private_liner)
"oO" = (
/obj/machinery/door/poddoor/preopen/personal_bay_one,
/turf/open/floor/plating/nanocarbon,
/area/shuttle/personally_bought/private_liner)
"oZ" = (
/obj/structure/mineral_door/manual_colony_door/shuttle/interior,
/turf/open/floor/plating/nanocarbon,
/area/shuttle/personally_bought/private_liner)
"pn" = (
/obj/machinery/atmospherics/components/unary/vent_pump/on/layer4{
	dir = 1
	},
/turf/open/floor/iron/colony/bolts/nanocarbon,
/area/shuttle/personally_bought/private_liner)
"qc" = (
/obj/structure/shuttle_decoration/extinguisher/directional/south,
/turf/closed/wall/mineral/nanocarbon/nodiagonal/primary_colour,
/area/shuttle/personally_bought/private_liner)
"qV" = (
/obj/machinery/door/airlock/spacer,
/obj/effect/mapping_helpers/airlock/cyclelink_helper,
/turf/open/floor/plating/nanocarbon,
/area/shuttle/personally_bought/private_liner)
"rS" = (
/turf/closed/wall/mineral/nanocarbon/nodiagonal/black,
/area/shuttle/personally_bought/private_liner)
"sF" = (
/obj/structure/tank_dispenser,
/turf/open/floor/plating/aluminum,
/area/shuttle/personally_bought/private_liner)
"sZ" = (
/obj/structure/shuttle_decoration/rcs/directional/north,
/obj/structure/shuttle_decoration/wall_plate/gold_foil,
/turf/closed/wall/mineral/nanocarbon/nodiagonal/primary_colour,
/area/shuttle/personally_bought/private_liner)
"tf" = (
/obj/machinery/computer/crew{
	dir = 4
	},
/obj/machinery/light/warm/directional/west,
/obj/structure/extinguisher_cabinet/directional/west,
/turf/open/floor/plating/nanocarbon,
/area/shuttle/personally_bought/private_liner)
"tm" = (
/obj/structure/shuttle_decoration/wall_plate/nanocarbon/secondary_colour,
/turf/closed/wall/mineral/nanocarbon/nodiagonal/secondary_colour,
/area/shuttle/personally_bought/private_liner)
"tN" = (
/obj/structure/shuttle_decoration/aux_engine/directional/east,
/turf/closed/wall/mineral/nanocarbon/nodiagonal/primary_colour,
/area/shuttle/personally_bought/private_liner)
"tZ" = (
/obj/machinery/airalarm/directional/north,
/obj/effect/mapping_helpers/airalarm/all_access,
/obj/machinery/atmospherics/pipe/smart/manifold4w/supply/hidden/layer4,
/obj/machinery/atmospherics/pipe/smart/manifold4w/scrubbers/hidden/layer2,
/turf/open/floor/iron/colony/nanocarbon,
/area/shuttle/personally_bought/private_liner)
"ul" = (
/obj/machinery/modular_computer/preset/civilian{
	dir = 4
	},
/turf/open/floor/plating/nanocarbon,
/area/shuttle/personally_bought/private_liner)
"vf" = (
/obj/machinery/door/poddoor/preopen/personal_bay_one,
/obj/machinery/button/door/personal_shuttle_bay_one/directional/north,
/obj/machinery/atmos_shield_gen/active{
	dir = 2
	},
/turf/open/floor/plating/nanocarbon,
/area/shuttle/personally_bought/private_liner)
"vh" = (
/obj/structure/closet/secure_closet/personal,
/obj/machinery/vending/wallmed/directional/north,
/turf/open/floor/plating/nanocarbon,
/area/shuttle/personally_bought/private_liner)
"vq" = (
/obj/structure/shuttle_decoration/extinguisher/directional/north,
/turf/closed/wall/mineral/nanocarbon/nodiagonal/primary_colour,
/area/shuttle/personally_bought/private_liner)
"vJ" = (
/obj/machinery/portable_atmospherics/canister/air,
/obj/machinery/atmospherics/components/unary/portables_connector/visible/layer4{
	dir = 1
	},
/turf/open/floor/plating/nanocarbon,
/area/shuttle/personally_bought/private_liner)
"vM" = (
/obj/structure/shuttle_decoration/junction_box/directional/west,
/turf/closed/wall/mineral/aluminum,
/area/shuttle/personally_bought/private_liner)
"wn" = (
/obj/machinery/holopad,
/obj/machinery/atmospherics/pipe/smart/manifold4w/scrubbers/hidden/layer2,
/turf/open/floor/iron/colony/white/nanocarbon,
/area/shuttle/personally_bought/private_liner)
"wI" = (
/turf/closed/wall/mineral/nanocarbon/nodiagonal/secondary_colour,
/area/shuttle/personally_bought/private_liner)
"wX" = (
/obj/structure/shuttle_decoration/wall_plate/nanocarbon/primary_colour,
/turf/closed/wall/mineral/nanocarbon/nodiagonal/primary_colour,
/area/shuttle/personally_bought/private_liner)
"xc" = (
/obj/machinery/button/door/personal_shuttle_windows/directional/south,
/obj/structure/closet/sleeping_compartment,
/turf/open/floor/plating/nanocarbon,
/area/shuttle/personally_bought/private_liner)
"yv" = (
/obj/structure/shuttle_decoration/bullbar/directional/south,
/turf/closed/wall/mineral/nanocarbon/nodiagonal/primary_colour,
/area/shuttle/personally_bought/private_liner)
"zu" = (
/obj/structure/chair/comfy/shuttle{
	dir = 8
	},
/turf/open/floor/plating/nanocarbon,
/area/shuttle/personally_bought/private_liner)
"zT" = (
/obj/structure/shuttle_decoration/wall_plate/nanocarbon/secondary_colour{
	dir = 1
	},
/turf/closed/wall/mineral/nanocarbon/nodiagonal/secondary_colour,
/area/shuttle/personally_bought/private_liner)
"Aq" = (
/obj/machinery/door/poddoor/preopen/personal_bay_one,
/obj/machinery/atmos_shield_gen/active{
	dir = 1
	},
/obj/machinery/button/door/personal_shuttle_bay_one/directional/south,
/turf/open/floor/plating/nanocarbon,
/area/shuttle/personally_bought/private_liner)
"AG" = (
/turf/open/floor/plating/nanocarbon,
/area/shuttle/personally_bought/private_liner)
"BU" = (
/obj/structure/closet/firecloset/shuttle,
/turf/open/floor/plating/nanocarbon,
/area/shuttle/personally_bought/private_liner)
"Ct" = (
/obj/machinery/suit_storage_unit/industrial/personal_shuttle/heavy,
/obj/machinery/light/warm/directional/north,
/turf/open/floor/plating/aluminum,
/area/shuttle/personally_bought/private_liner)
"CR" = (
/obj/machinery/atmospherics/components/unary/vent_scrubber/on/layer2{
	dir = 8
	},
/obj/machinery/atmospherics/pipe/smart/manifold4w/supply/hidden/layer4,
/turf/open/floor/catwalk_floor/colony_fabricator/nanocarbon,
/area/shuttle/personally_bought/private_liner)
"DH" = (
/obj/machinery/power/apc/auto_name/directional/east,
/obj/effect/mapping_helpers/apc/unlocked,
/obj/effect/mapping_helpers/apc/cell_5k,
/obj/structure/chair/comfy/shuttle{
	dir = 8
	},
/obj/machinery/atmospherics/components/unary/vent_pump/on/layer4,
/obj/machinery/atmospherics/pipe/smart/manifold4w/scrubbers/hidden/layer2,
/obj/structure/cable,
/turf/open/floor/iron/colony/white/texture/nanocarbon,
/area/shuttle/personally_bought/private_liner)
"DI" = (
/obj/structure/closet/firecloset/shuttle/tools,
/obj/machinery/light/blacklight/directional/east,
/turf/open/floor/plating/nanocarbon,
/area/shuttle/personally_bought/private_liner)
"DN" = (
/obj/effect/spawner/random/salvage/container_or_crate_or_cargo/civilian_supply,
/obj/machinery/light/red/directional/south,
/turf/open/floor/plating/aluminum,
/area/shuttle/personally_bought/private_liner)
"FD" = (
/obj/structure/mineral_door/manual_colony_door/shuttle/interior,
/obj/machinery/atmospherics/pipe/smart/manifold4w/supply/hidden/layer4,
/obj/machinery/atmospherics/pipe/smart/manifold4w/scrubbers/hidden/layer2,
/turf/open/floor/plating/nanocarbon,
/area/shuttle/personally_bought/private_liner)
"Gi" = (
/obj/machinery/power/shuttle_engine/propulsion{
	dir = 8
	},
/obj/structure/engine_covers/thruster_nozzle{
	dir = 8
	},
/turf/open/floor/plating/nanocarbon/airless,
/area/shuttle/personally_bought/private_liner)
"GB" = (
/obj/structure/shuttle_decoration/wall_plate/armor,
/obj/structure/shuttle_decoration/wall_plate/armor{
	dir = 1
	},
/turf/closed/wall/mineral/aluminum,
/area/shuttle/personally_bought/private_liner)
"GR" = (
/obj/machinery/computer/shuttle/personally_bought{
	dir = 8
	},
/obj/item/radio/intercom/directional/east,
/turf/open/floor/plating/nanocarbon,
/area/shuttle/personally_bought/private_liner)
"HV" = (
/obj/structure/shuttle_decoration/radiator/directional/north,
/turf/closed/wall/mineral/nanocarbon/nodiagonal/black,
/area/shuttle/personally_bought/private_liner)
"If" = (
/obj/machinery/power/shuttle_engine/heater{
	dir = 8
	},
/obj/structure/engine_covers/heater_cover{
	dir = 4
	},
/turf/open/floor/plating/nanocarbon/airless,
/area/shuttle/personally_bought/private_liner)
"Ir" = (
/obj/machinery/computer/camera_advanced/shuttle_docker/personally_bought{
	x_offset = -4;
	y_offset = 5;
	view_range = 4;
	dir = 8
	},
/turf/open/floor/plating/nanocarbon,
/area/shuttle/personally_bought/private_liner)
"Jw" = (
/obj/structure/toilet/space,
/obj/structure/sink/cycler/directional/east,
/turf/open/floor/iron/colony/white/texture/nanocarbon,
/area/shuttle/personally_bought/private_liner)
"JA" = (
/obj/structure/shuttle_decoration/bullbar/directional/south,
/obj/structure/shuttle_decoration/junction_box/directional/north,
/turf/closed/wall/mineral/nanocarbon/nodiagonal/primary_colour,
/area/shuttle/personally_bought/private_liner)
"JC" = (
/obj/structure/table/reinforced,
/obj/machinery/coffeemaker,
/turf/open/floor/plating/nanocarbon,
/area/shuttle/personally_bought/private_liner)
"JH" = (
/obj/structure/railing{
	dir = 1
	},
/obj/effect/spawner/random/salvage/crate_only/civilian_supply,
/obj/machinery/light/warm/directional/west,
/turf/open/floor/plating/nanocarbon,
/area/shuttle/personally_bought/private_liner)
"Kc" = (
/obj/structure/shuttle_decoration/headlight/directional/east,
/turf/closed/wall/mineral/nanocarbon/nodiagonal/primary_colour,
/area/shuttle/personally_bought/private_liner)
"Kk" = (
/obj/structure/extinguisher_cabinet/directional/east,
/obj/machinery/atmospherics/components/unary/vent_pump/on/layer4,
/obj/machinery/atmospherics/pipe/smart/manifold4w/scrubbers/hidden/layer2,
/turf/open/floor/iron/colony/nanocarbon,
/area/shuttle/personally_bought/private_liner)
"KD" = (
/obj/machinery/atmospherics/pipe/smart/manifold4w/supply/hidden/layer4,
/obj/machinery/atmospherics/pipe/smart/manifold4w/scrubbers/hidden/layer2,
/obj/structure/cable,
/turf/open/floor/catwalk_floor/colony_fabricator/nanocarbon,
/area/shuttle/personally_bought/private_liner)
"KF" = (
/turf/template_noop,
/area/template_noop)
"KG" = (
/turf/closed/wall/mineral/aluminum,
/area/shuttle/personally_bought/private_liner)
"KO" = (
/obj/machinery/light/red/dim/directional/west,
/obj/structure/closet/emcloset/anchored,
/turf/open/floor/plating/nanocarbon,
/area/shuttle/personally_bought/private_liner)
"KY" = (
/obj/structure/shuttle_decoration/wall_plate/nanocarbon/diagonal/primary_colour{
	dir = 9
	},
/turf/closed/wall/mineral/nanocarbon/primary_colour,
/area/shuttle/personally_bought/private_liner)
"LQ" = (
/obj/structure/chair/comfy/shuttle{
	dir = 8
	},
/obj/structure/railing{
	dir = 1
	},
/obj/structure/extinguisher_cabinet/directional/east,
/obj/machinery/light/warm/directional/east,
/turf/open/floor/plating/nanocarbon,
/area/shuttle/personally_bought/private_liner)
"LV" = (
/obj/structure/railing{
	dir = 1
	},
/turf/open/floor/iron/colony/bolts/nanocarbon,
/area/shuttle/personally_bought/private_liner)
"Mx" = (
/obj/structure/shuttle_decoration/wall_plate/gold_foil{
	dir = 8
	},
/obj/structure/shuttle_decoration/wall_plate/plastamic{
	dir = 4
	},
/turf/closed/wall/mineral/aluminum,
/area/shuttle/personally_bought/private_liner)
"MA" = (
/obj/structure/mineral_door/manual_colony_door/shuttle/interior,
/obj/structure/cable,
/obj/machinery/atmospherics/pipe/smart/manifold4w/supply/hidden/layer4,
/obj/machinery/atmospherics/pipe/smart/manifold4w/scrubbers/hidden/layer2,
/turf/open/floor/plating/nanocarbon,
/area/shuttle/personally_bought/private_liner)
"MM" = (
/obj/structure/shuttle_decoration/wall_plate/nanocarbon/primary_colour{
	dir = 1
	},
/turf/closed/wall/mineral/nanocarbon/nodiagonal/primary_colour,
/area/shuttle/personally_bought/private_liner)
"Nw" = (
/obj/machinery/button/door/personal_shuttle_bay_one/directional/east,
/obj/machinery/portable_atmospherics/canister/oxygen,
/turf/open/floor/plating/aluminum,
/area/shuttle/personally_bought/private_liner)
"NC" = (
/obj/structure/shuttle_decoration/wall_plate/gold_foil{
	dir = 8
	},
/turf/closed/wall/mineral/aluminum,
/area/shuttle/personally_bought/private_liner)
"Oi" = (
/obj/structure/shuttle_decoration/extinguisher/directional/north,
/obj/structure/shuttle_decoration/wall_plate/gold_foil,
/turf/closed/wall/mineral/nanocarbon/nodiagonal/primary_colour,
/area/shuttle/personally_bought/private_liner)
"Os" = (
/obj/structure/shuttle_decoration/ladder/directional/south,
/turf/closed/wall/mineral/nanocarbon/nodiagonal/primary_colour,
/area/shuttle/personally_bought/private_liner)
"Ov" = (
/obj/machinery/atmospherics/pipe/smart/manifold4w/supply/hidden/layer4,
/obj/machinery/atmospherics/pipe/smart/manifold4w/scrubbers/hidden/layer2,
/obj/machinery/meter/layer2,
/turf/open/floor/iron/colony/nanocarbon,
/area/shuttle/personally_bought/private_liner)
"OC" = (
/obj/structure/shuttle_decoration/wall_plate/armor,
/turf/closed/wall/mineral/nanocarbon/nodiagonal/black,
/area/shuttle/personally_bought/private_liner)
"OH" = (
/turf/closed/wall/mineral/nanocarbon/nodiagonal/primary_colour,
/area/shuttle/personally_bought/private_liner)
"Po" = (
/obj/structure/cable,
/obj/machinery/atmospherics/pipe/smart/manifold4w/supply/hidden/layer4,
/obj/machinery/atmospherics/pipe/smart/manifold4w/scrubbers/hidden/layer2,
/obj/machinery/meter/layer4,
/obj/effect/landmark/ship_captain_spawner,
/turf/open/floor/catwalk_floor/colony_fabricator/nanocarbon,
/area/shuttle/personally_bought/private_liner)
"Pv" = (
/obj/effect/spawner/random/salvage/container_or_crate_or_cargo/civilian_supply,
/turf/open/floor/plating/aluminum,
/area/shuttle/personally_bought/private_liner)
"Py" = (
/obj/structure/chair/comfy/shuttle{
	dir = 8
	},
/turf/open/floor/iron/colony/nanocarbon,
/area/shuttle/personally_bought/private_liner)
"PT" = (
/obj/machinery/power/micro_reactor,
/obj/structure/cable,
/turf/open/floor/plating/nanocarbon,
/area/shuttle/personally_bought/private_liner)
"Qy" = (
/obj/machinery/atmospherics/pipe/smart/manifold4w/supply/hidden/layer4,
/obj/machinery/atmospherics/pipe/smart/manifold4w/scrubbers/hidden/layer2,
/turf/open/floor/catwalk_floor/colony_fabricator/nanocarbon,
/area/shuttle/personally_bought/private_liner)
"RH" = (
/turf/open/floor/plating/aluminum,
/area/shuttle/personally_bought/private_liner)
"RQ" = (
/obj/docking_port/mobile/personally_bought,
/obj/machinery/door/airlock/spacer,
/obj/effect/mapping_helpers/airlock/cyclelink_helper{
	dir = 1
	},
/turf/open/floor/plating/nanocarbon,
/area/shuttle/personally_bought/private_liner)
"RS" = (
/obj/machinery/atmospherics/components/unary/vent_pump/on/layer4{
	dir = 8
	},
/turf/open/floor/iron/colony/nanocarbon,
/area/shuttle/personally_bought/private_liner)
"Ti" = (
/obj/structure/shuttle_decoration/rcs/directional/south,
/obj/structure/shuttle_decoration/wall_plate/gold_foil{
	dir = 1
	},
/turf/closed/wall/mineral/nanocarbon/nodiagonal/primary_colour,
/area/shuttle/personally_bought/private_liner)
"TL" = (
/obj/machinery/portable_atmospherics/canister/oxygen,
/obj/machinery/light/warm/directional/south,
/turf/open/floor/plating/aluminum,
/area/shuttle/personally_bought/private_liner)
"UT" = (
/obj/structure/mineral_door/manual_colony_door/shuttle/interior,
/obj/machinery/atmospherics/pipe/smart/manifold4w/supply/hidden/layer4,
/obj/machinery/atmospherics/pipe/smart/manifold4w/scrubbers/hidden/layer2,
/obj/structure/cable,
/turf/open/floor/plating/nanocarbon,
/area/shuttle/personally_bought/private_liner)
"Xf" = (
/obj/machinery/atmospherics/components/unary/vent_scrubber/on/layer2{
	dir = 1
	},
/turf/open/floor/iron/colony/bolts/nanocarbon,
/area/shuttle/personally_bought/private_liner)
"Xu" = (
/obj/machinery/portable_atmospherics/canister,
/obj/machinery/atmospherics/components/unary/portables_connector/visible/layer2{
	dir = 1
	},
/obj/machinery/light/blacklight/directional/east,
/turf/open/floor/plating/nanocarbon,
/area/shuttle/personally_bought/private_liner)
"Xy" = (
/obj/machinery/atmospherics/components/unary/vent_scrubber/on/layer2{
	dir = 4
	},
/obj/structure/shuttle_decoration/liquid_tank/coolant,
/turf/open/floor/plating/nanocarbon,
/area/shuttle/personally_bought/private_liner)
"YM" = (
/obj/structure/shuttle_decoration/bullbar/directional/north,
/turf/closed/wall/mineral/nanocarbon/nodiagonal/secondary_colour,
/area/shuttle/personally_bought/private_liner)
"ZM" = (
/obj/structure/shuttle_decoration/rcs/directional/south,
/turf/closed/wall/mineral/nanocarbon/nodiagonal/secondary_colour,
/area/shuttle/personally_bought/private_liner)

(1,1,1) = {"
KF
KF
GB
ic
ic
GB
ic
ic
GB
"}
(2,1,1) = {"
KF
KF
ig
Gi
Gi
rS
Gi
Gi
OC
"}
(3,1,1) = {"
KF
KF
HV
If
If
rS
If
If
ea
"}
(4,1,1) = {"
KF
KF
sZ
BU
Xy
PT
fb
vJ
Ti
"}
(5,1,1) = {"
KF
KF
Oi
DI
Kk
Po
Ov
Xu
kS
"}
(6,1,1) = {"
KY
OH
OH
NC
KG
MA
vM
Mx
Os
"}
(7,1,1) = {"
MM
iB
tf
bf
dc
eb
KG
KO
OH
"}
(8,1,1) = {"
dc
mP
wn
DH
UT
KD
qV
bg
RQ
"}
(9,1,1) = {"
dc
Ir
GR
KG
KG
FD
KG
la
OH
"}
(10,1,1) = {"
Kc
dc
OH
KG
ul
nC
JH
fh
wX
"}
(11,1,1) = {"
KF
KF
MM
bU
Py
Qy
pn
JC
dc
"}
(12,1,1) = {"
KF
KF
YM
vh
hy
cG
LV
xc
bl
"}
(13,1,1) = {"
KF
KF
zT
KG
KG
tZ
Xf
bU
dc
"}
(14,1,1) = {"
KF
KF
zT
Jw
oZ
nC
LQ
zu
tm
"}
(15,1,1) = {"
KF
KF
cH
KG
KG
FD
KG
vM
yv
"}
(16,1,1) = {"
KF
KF
dc
fG
RH
Qy
RH
sF
dc
"}
(17,1,1) = {"
KF
KF
cH
Ct
bQ
Qy
Nw
TL
JA
"}
(18,1,1) = {"
KF
KF
cP
KG
KG
hm
KG
KG
wI
"}
(19,1,1) = {"
KF
KF
km
jj
Pv
Qy
RH
DN
ZM
"}
(20,1,1) = {"
KF
KF
vq
am
RH
CR
Pv
Pv
qc
"}
(21,1,1) = {"
KF
KF
tN
OH
AG
RS
AG
OH
tN
"}
(22,1,1) = {"
KF
KF
KF
Kc
vf
oO
Aq
Kc
KF
"}
