//MAP CONVERTED BY dmm2tgm.py THIS HEADER COMMENT PREVENTS RECONVERSION, DO NOT REMOVE
"ae" = (
/obj/effect/spawner/random/salvage/crate_only/civilian_supply,
/obj/machinery/atmospherics/components/unary/vent_scrubber/on/layer2,
/obj/structure/sign/calendar/directional/east,
/turf/open/floor/plating/nanocarbon,
/area/shuttle/personally_bought/people_mover)
"ai" = (
/obj/structure/mineral_door/manual_colony_door/shuttle/interior,
/obj/machinery/atmospherics/pipe/smart/manifold4w/supply/hidden/layer4,
/obj/machinery/atmospherics/pipe/smart/manifold4w/scrubbers/hidden/layer2,
/turf/open/floor/plating/nanocarbon,
/area/shuttle/personally_bought/people_mover)
"aL" = (
/obj/structure/shuttle_decoration/extinguisher/directional/south,
/obj/structure/shuttle_decoration/wall_plate/gold_foil{
	dir = 1
	},
/turf/closed/wall/mineral/nanocarbon/nodiagonal/secondary_colour,
/area/shuttle/personally_bought/people_mover)
"co" = (
/obj/structure/shuttle_decoration/wall_plate/plastamic,
/turf/closed/wall/mineral/nanocarbon/nodiagonal/primary_colour,
/area/shuttle/personally_bought/people_mover)
"dh" = (
/obj/structure/shuttle_decoration/wall_plate/plastamic{
	dir = 8
	},
/turf/closed/wall/mineral/aluminum,
/area/shuttle/personally_bought/people_mover)
"dR" = (
/obj/structure/extinguisher_cabinet/directional/east,
/obj/machinery/atmospherics/components/unary/vent_pump/on/layer4,
/obj/machinery/atmospherics/pipe/smart/manifold4w/scrubbers/hidden/layer2,
/turf/open/floor/iron/colony/nanocarbon,
/area/shuttle/personally_bought/people_mover)
"gV" = (
/obj/structure/shuttle_decoration/wall_plate/plastamic{
	dir = 4
	},
/turf/closed/wall/mineral/aluminum,
/area/shuttle/personally_bought/people_mover)
"hR" = (
/obj/structure/shuttle_decoration/radiator/directional/south,
/turf/closed/wall/mineral/nanocarbon/nodiagonal/black,
/area/shuttle/personally_bought/people_mover)
"ie" = (
/turf/closed/wall/mineral/nanocarbon/nodiagonal/black,
/area/shuttle/personally_bought/people_mover)
"iJ" = (
/obj/machinery/wall_healer/free/directional/east,
/obj/machinery/atmospherics/pipe/smart/manifold4w/supply/hidden/layer4,
/obj/machinery/atmospherics/pipe/smart/manifold4w/scrubbers/hidden/layer2,
/turf/open/floor/iron/colony/texture/nanocarbon,
/area/shuttle/personally_bought/people_mover)
"iX" = (
/obj/structure/shuttle_decoration/rcs/directional/south,
/obj/structure/shuttle_decoration/wall_plate/gold_foil{
	dir = 1
	},
/turf/closed/wall/mineral/nanocarbon/nodiagonal/primary_colour,
/area/shuttle/personally_bought/people_mover)
"jx" = (
/obj/structure/shuttle_decoration/extinguisher/directional/north,
/obj/structure/shuttle_decoration/wall_plate/gold_foil,
/turf/closed/wall/mineral/nanocarbon/nodiagonal/secondary_colour,
/area/shuttle/personally_bought/people_mover)
"jM" = (
/obj/structure/chair/comfy/shuttle,
/obj/machinery/vending/wallmed/directional/north,
/turf/open/floor/plating/nanocarbon,
/area/shuttle/personally_bought/people_mover)
"np" = (
/obj/structure/shuttle_decoration/rcs/directional/north,
/obj/structure/shuttle_decoration/wall_plate/gold_foil,
/turf/closed/wall/mineral/nanocarbon/nodiagonal/primary_colour,
/area/shuttle/personally_bought/people_mover)
"nC" = (
/obj/machinery/power/shuttle_engine/propulsion{
	dir = 8
	},
/obj/structure/engine_covers/thruster_nozzle{
	dir = 8
	},
/turf/open/floor/plating/nanocarbon/airless,
/area/shuttle/personally_bought/people_mover)
"or" = (
/obj/structure/cable,
/obj/machinery/atmospherics/pipe/smart/manifold4w/supply/hidden/layer4,
/obj/machinery/atmospherics/pipe/smart/manifold4w/scrubbers/hidden/layer2,
/obj/machinery/meter/layer4,
/obj/effect/landmark/ship_captain_spawner,
/turf/open/floor/catwalk_floor/colony_fabricator/nanocarbon,
/area/shuttle/personally_bought/people_mover)
"ow" = (
/obj/machinery/light/red/dim/directional/west,
/turf/open/floor/catwalk_floor/colony_fabricator/nanocarbon,
/area/shuttle/personally_bought/people_mover)
"oI" = (
/obj/structure/window/fulltile/salvage_shuttle,
/obj/machinery/door/poddoor/preopen/personal_shuttle_windows,
/turf/open/floor/plating/nanocarbon,
/area/shuttle/personally_bought/people_mover)
"pf" = (
/turf/closed/wall/mineral/nanocarbon/nodiagonal/primary_colour,
/area/shuttle/personally_bought/people_mover)
"pg" = (
/obj/machinery/atmospherics/pipe/smart/manifold4w/supply/hidden/layer4,
/obj/machinery/atmospherics/pipe/smart/manifold4w/scrubbers/hidden/layer2,
/obj/machinery/meter/layer2,
/turf/open/floor/iron/colony/nanocarbon,
/area/shuttle/personally_bought/people_mover)
"pV" = (
/obj/machinery/holopad,
/obj/machinery/atmospherics/pipe/smart/manifold4w/supply/hidden/layer4,
/obj/machinery/atmospherics/pipe/smart/manifold4w/scrubbers/hidden/layer2,
/turf/open/floor/iron/colony/nanocarbon,
/area/shuttle/personally_bought/people_mover)
"qy" = (
/obj/machinery/power/apc/auto_name/directional/south,
/obj/structure/cable,
/obj/machinery/atmospherics/pipe/smart/manifold4w/supply/hidden/layer4,
/obj/machinery/atmospherics/pipe/smart/manifold4w/scrubbers/hidden/layer2,
/obj/effect/mapping_helpers/apc/cell_5k,
/obj/effect/mapping_helpers/apc/unlocked,
/turf/open/floor/iron/colony/nanocarbon,
/area/shuttle/personally_bought/people_mover)
"us" = (
/obj/structure/shuttle_decoration/wall_plate/armor,
/turf/closed/wall/mineral/nanocarbon/nodiagonal/black,
/area/shuttle/personally_bought/people_mover)
"ux" = (
/obj/machinery/computer/camera_advanced/shuttle_docker/personally_bought{
	view_range = 2;
	y_offset = 5;
	dir = 8
	},
/obj/item/radio/intercom/directional/east,
/obj/machinery/button/door/personal_shuttle_windows/directional/north,
/obj/machinery/atmospherics/components/unary/vent_scrubber/on/layer2{
	dir = 8
	},
/turf/open/floor/plating/nanocarbon,
/area/shuttle/personally_bought/people_mover)
"uy" = (
/obj/structure/shuttle_decoration/wall_plate/armor,
/obj/structure/shuttle_decoration/wall_plate/armor{
	dir = 1
	},
/turf/closed/wall/mineral/aluminum,
/area/shuttle/personally_bought/people_mover)
"uI" = (
/obj/effect/spawner/random/salvage/crate_only/civilian_supply,
/obj/machinery/atmospherics/components/unary/vent_pump/on/layer4,
/obj/machinery/airalarm/directional/west,
/obj/effect/mapping_helpers/airalarm/all_access,
/turf/open/floor/plating/nanocarbon,
/area/shuttle/personally_bought/people_mover)
"vv" = (
/obj/structure/shuttle_decoration/ladder/directional/north,
/turf/closed/wall/mineral/nanocarbon/nodiagonal/secondary_colour,
/area/shuttle/personally_bought/people_mover)
"vU" = (
/obj/effect/turf_decal/stripes/white/line{
	dir = 4
	},
/turf/open/floor/plating/nanocarbon/exterior/black,
/area/shuttle/personally_bought/people_mover)
"xe" = (
/obj/structure/shuttle_decoration/ladder/directional/south,
/turf/closed/wall/mineral/nanocarbon/nodiagonal/secondary_colour,
/area/shuttle/personally_bought/people_mover)
"xj" = (
/obj/machinery/power/shuttle_engine/heater{
	dir = 8
	},
/obj/structure/engine_covers/heater_cover{
	dir = 4
	},
/turf/open/floor/plating/nanocarbon/airless,
/area/shuttle/personally_bought/people_mover)
"xz" = (
/obj/structure/shuttle_decoration/bullbar/directional/east,
/obj/structure/shuttle_decoration/headlight/directional/east,
/turf/closed/wall/mineral/nanocarbon/nodiagonal/primary_colour,
/area/shuttle/personally_bought/people_mover)
"xN" = (
/turf/closed/wall/mineral/nanocarbon/primary_colour,
/area/shuttle/personally_bought/people_mover)
"zg" = (
/obj/machinery/portable_atmospherics/canister/air,
/obj/machinery/atmospherics/components/unary/portables_connector/visible/layer4{
	dir = 1
	},
/turf/open/floor/plating/nanocarbon,
/area/shuttle/personally_bought/people_mover)
"Bq" = (
/obj/machinery/exoscanner/shuttle_part/radio_dish/directional/east,
/turf/closed/wall/mineral/nanocarbon/nodiagonal/secondary_colour,
/area/shuttle/personally_bought/people_mover)
"BK" = (
/obj/machinery/door/airlock/spacer,
/obj/effect/mapping_helpers/airlock/cyclelink_helper,
/turf/open/floor/plating/nanocarbon,
/area/shuttle/personally_bought/people_mover)
"Db" = (
/obj/structure/shuttle_decoration/radiator/directional/north,
/turf/closed/wall/mineral/nanocarbon/nodiagonal/black,
/area/shuttle/personally_bought/people_mover)
"DE" = (
/obj/structure/closet/firecloset/shuttle/tools,
/obj/machinery/light/blacklight/directional/east,
/turf/open/floor/plating/nanocarbon,
/area/shuttle/personally_bought/people_mover)
"Es" = (
/obj/structure/mineral_door/manual_colony_door/shuttle/interior,
/obj/structure/cable,
/obj/machinery/atmospherics/pipe/smart/manifold4w/supply/hidden/layer4,
/obj/machinery/atmospherics/pipe/smart/manifold4w/scrubbers/hidden/layer2,
/turf/open/floor/plating/nanocarbon,
/area/shuttle/personally_bought/people_mover)
"EW" = (
/obj/structure/shelf,
/obj/item/storage/toolbox/emergency,
/obj/item/binoculars,
/obj/item/trench_tool,
/obj/machinery/atmospherics/components/unary/vent_pump/on/layer4{
	dir = 4
	},
/obj/machinery/light/warm/directional/west,
/turf/open/floor/plating/nanocarbon,
/area/shuttle/personally_bought/people_mover)
"Fw" = (
/obj/structure/shuttle_decoration/junction_box/directional/west,
/turf/closed/wall/mineral/aluminum,
/area/shuttle/personally_bought/people_mover)
"FC" = (
/obj/structure/shuttle_decoration/wall_plate/armor{
	dir = 1
	},
/turf/closed/wall/mineral/nanocarbon/nodiagonal/black,
/area/shuttle/personally_bought/people_mover)
"Gc" = (
/obj/machinery/power/micro_reactor,
/obj/structure/cable,
/turf/open/floor/plating/nanocarbon,
/area/shuttle/personally_bought/people_mover)
"Gg" = (
/obj/machinery/modular_computer/preset/engineering{
	dir = 4
	},
/obj/structure/secure_safe/directional/west,
/turf/open/floor/plating/nanocarbon,
/area/shuttle/personally_bought/people_mover)
"GF" = (
/obj/structure/shuttle_decoration/wall_plate/gold_foil{
	dir = 8
	},
/turf/closed/wall/mineral/aluminum,
/area/shuttle/personally_bought/people_mover)
"GK" = (
/obj/structure/closet/firecloset/shuttle,
/turf/open/floor/plating/nanocarbon,
/area/shuttle/personally_bought/people_mover)
"HL" = (
/obj/structure/chair/comfy/shuttle{
	dir = 4
	},
/turf/open/floor/iron/colony/nanocarbon,
/area/shuttle/personally_bought/people_mover)
"HN" = (
/obj/structure/cable,
/obj/machinery/atmospherics/pipe/smart/manifold4w/supply/hidden/layer4,
/obj/machinery/atmospherics/pipe/smart/manifold4w/scrubbers/hidden/layer2,
/turf/open/floor/iron/colony/nanocarbon,
/area/shuttle/personally_bought/people_mover)
"IA" = (
/obj/structure/shuttle_decoration/wall_plate/gold_foil{
	dir = 8
	},
/obj/structure/shuttle_decoration/wall_plate/plastamic{
	dir = 4
	},
/turf/closed/wall/mineral/aluminum,
/area/shuttle/personally_bought/people_mover)
"Ki" = (
/turf/closed/wall/mineral/nanocarbon/nodiagonal/secondary_colour,
/area/shuttle/personally_bought/people_mover)
"Lj" = (
/obj/structure/cable,
/obj/machinery/atmospherics/pipe/smart/manifold4w/supply/hidden/layer4,
/obj/machinery/atmospherics/pipe/smart/manifold4w/scrubbers/hidden/layer2,
/turf/open/floor/iron/colony/texture/nanocarbon,
/area/shuttle/personally_bought/people_mover)
"Lt" = (
/obj/structure/shuttle_decoration/rcs/directional/south,
/turf/closed/wall/mineral/nanocarbon/nodiagonal/primary_colour,
/area/shuttle/personally_bought/people_mover)
"LJ" = (
/obj/machinery/portable_atmospherics/canister,
/obj/machinery/atmospherics/components/unary/portables_connector/visible/layer2{
	dir = 1
	},
/obj/machinery/light/blacklight/directional/east,
/turf/open/floor/plating/nanocarbon,
/area/shuttle/personally_bought/people_mover)
"NL" = (
/obj/machinery/suit_storage_unit/industrial/personal_shuttle,
/obj/machinery/atmospherics/pipe/smart/manifold4w/supply/hidden/layer4,
/turf/open/floor/plating/nanocarbon,
/area/shuttle/personally_bought/people_mover)
"Ok" = (
/turf/closed/wall/mineral/nanocarbon/secondary_colour,
/area/shuttle/personally_bought/people_mover)
"Qc" = (
/obj/structure/shuttle_decoration/rcs/directional/north,
/turf/closed/wall/mineral/nanocarbon/nodiagonal/primary_colour,
/area/shuttle/personally_bought/people_mover)
"Qw" = (
/turf/closed/wall/mineral/aluminum,
/area/shuttle/personally_bought/people_mover)
"QF" = (
/obj/structure/fans/tiny,
/obj/docking_port/mobile/personally_bought,
/obj/machinery/door/airlock/spacer,
/obj/effect/mapping_helpers/airlock/cyclelink_helper{
	dir = 1
	},
/turf/open/floor/plating/nanocarbon,
/area/shuttle/personally_bought/people_mover)
"RY" = (
/obj/machinery/computer/shuttle/personally_bought{
	dir = 8
	},
/turf/open/floor/plating/nanocarbon,
/area/shuttle/personally_bought/people_mover)
"Sd" = (
/obj/structure/shuttle_decoration/bullbar/directional/east,
/turf/closed/wall/mineral/nanocarbon/nodiagonal/primary_colour,
/area/shuttle/personally_bought/people_mover)
"Tw" = (
/turf/template_noop,
/area/template_noop)
"TM" = (
/obj/machinery/atmospherics/components/unary/vent_scrubber/on/layer2{
	dir = 4
	},
/obj/structure/shuttle_decoration/liquid_tank/coolant,
/turf/open/floor/plating/nanocarbon,
/area/shuttle/personally_bought/people_mover)
"Vh" = (
/obj/structure/extinguisher_cabinet/directional/south,
/obj/machinery/atmospherics/pipe/smart/manifold4w/supply/hidden/layer4,
/obj/machinery/atmospherics/pipe/smart/manifold4w/scrubbers/hidden/layer2,
/turf/open/floor/iron/colony/nanocarbon,
/area/shuttle/personally_bought/people_mover)
"WY" = (
/obj/structure/shuttle_decoration/console/directional/south,
/turf/closed/wall/mineral/nanocarbon/nodiagonal/primary_colour,
/area/shuttle/personally_bought/people_mover)
"ZI" = (
/obj/structure/chair/comfy/shuttle,
/obj/machinery/digital_clock/directional/north,
/obj/machinery/light/warm/directional/north,
/turf/open/floor/plating/nanocarbon,
/area/shuttle/personally_bought/people_mover)

(1,1,1) = {"
uy
vU
vU
uy
vU
vU
uy
"}
(2,1,1) = {"
FC
nC
nC
ie
nC
nC
us
"}
(3,1,1) = {"
Db
xj
xj
ie
xj
xj
hR
"}
(4,1,1) = {"
np
GK
TM
Gc
NL
zg
iX
"}
(5,1,1) = {"
jx
DE
dR
or
pg
LJ
aL
"}
(6,1,1) = {"
vv
GF
gV
Es
Fw
IA
xe
"}
(7,1,1) = {"
WY
uI
HN
Lj
BK
ow
QF
"}
(8,1,1) = {"
pf
jM
qy
Qw
Qw
dh
pf
"}
(9,1,1) = {"
Qc
ZI
Vh
Qw
EW
Gg
Lt
"}
(10,1,1) = {"
co
ae
iJ
ai
pV
HL
oI
"}
(11,1,1) = {"
Ki
Ki
pf
pf
ux
RY
oI
"}
(12,1,1) = {"
Ok
Bq
Tw
Sd
xz
oI
xN
"}
