//MAP CONVERTED BY dmm2tgm.py THIS HEADER COMMENT PREVENTS RECONVERSION, DO NOT REMOVE
"ae" = (
/obj/structure/chair/comfy/shuttle{
	dir = 1
	},
/obj/effect/turf_decal/box/red/corners,
/obj/effect/turf_decal/box/red/corners{
	dir = 4
	},
/turf/open/floor/iron/dark/smooth_large,
/area/shuttle/personally_bought/people_mover)
"ai" = (
/obj/machinery/modular_computer/preset/engineering{
	dir = 1
	},
/obj/structure/cable,
/obj/effect/turf_decal/bot_white,
/obj/machinery/suit_storage_unit/industrial/personal_shuttle,
/obj/machinery/button/door/personal_shuttle_windows/directional/north,
/obj/machinery/vending/wallmed/directional/west,
/turf/open/floor/iron/dark/smooth_large,
/area/shuttle/personally_bought/people_mover)
"aL" = (
/turf/closed/wall/mineral/plastitanium,
/area/shuttle/personally_bought/people_mover)
"co" = (
/obj/structure/cable,
/obj/machinery/atmospherics/pipe/smart/manifold4w/supply/hidden/layer4,
/obj/machinery/atmospherics/pipe/smart/manifold4w/scrubbers/hidden/layer2,
/turf/open/floor/catwalk_floor/iron_smooth,
/area/shuttle/personally_bought/people_mover)
"dh" = (
/obj/machinery/atmospherics/pipe/smart/manifold4w/supply/hidden/layer4,
/obj/machinery/atmospherics/pipe/smart/manifold4w/scrubbers/hidden/layer2,
/turf/open/floor/catwalk_floor/iron_dark,
/area/shuttle/personally_bought/people_mover)
"dR" = (
/obj/machinery/atmospherics/pipe/smart/manifold4w/scrubbers/hidden/layer2,
/obj/machinery/atmospherics/pipe/smart/manifold4w/supply/hidden/layer4,
/obj/structure/cable,
/obj/machinery/power/micro_reactor,
/obj/effect/landmark/ship_captain_spawner,
/turf/open/floor/iron/dark/smooth_large,
/area/shuttle/personally_bought/people_mover)
"gV" = (
/obj/machinery/atmospherics/pipe/smart/manifold4w/scrubbers/hidden/layer2,
/obj/machinery/atmospherics/pipe/smart/manifold4w/supply/hidden/layer4,
/obj/structure/cable,
/turf/open/floor/iron/smooth,
/area/shuttle/personally_bought/people_mover)
"hR" = (
/obj/structure/railing/eva_handhold/directional/south,
/turf/closed/wall/mineral/plastitanium/nodiagonal,
/area/shuttle/personally_bought/people_mover)
"ie" = (
/obj/effect/turf_decal/stripes/line{
	dir = 4
	},
/obj/machinery/power/shuttle_engine/heater{
	dir = 8
	},
/obj/structure/window/reinforced/plasma/spawner/directional/east,
/turf/open/floor/plating/airless,
/area/shuttle/personally_bought/people_mover)
"iJ" = (
/obj/structure/sign/calendar/directional/north,
/obj/structure/chair/comfy/shuttle,
/obj/effect/turf_decal/box/red/corners{
	dir = 1
	},
/obj/effect/turf_decal/box/red/corners{
	dir = 8
	},
/turf/open/floor/iron/dark/smooth_large,
/area/shuttle/personally_bought/people_mover)
"iX" = (
/obj/item/tether_anchor{
	anchored = 1
	},
/turf/closed/wall/mineral/plastitanium/nodiagonal,
/area/shuttle/personally_bought/people_mover)
"jx" = (
/obj/structure/marker_beacon/olive,
/turf/closed/wall/mineral/titanium,
/area/shuttle/personally_bought/people_mover)
"jM" = (
/obj/machinery/computer/camera_advanced/shuttle_docker/personally_bought{
	view_range = 2;
	y_offset = 5;
	dir = 1
	},
/obj/effect/turf_decal/bot_white,
/turf/open/floor/iron/dark/smooth_large,
/area/shuttle/personally_bought/people_mover)
"mf" = (
/obj/structure/marker_beacon/burgundy,
/turf/closed/wall/mineral/plastitanium,
/area/shuttle/personally_bought/people_mover)
"np" = (
/obj/machinery/atmospherics/pipe/smart/manifold4w/supply/hidden/layer4,
/obj/effect/turf_decal/delivery/white,
/obj/machinery/atmospherics/pipe/smart/manifold4w/scrubbers/hidden/layer2,
/obj/machinery/door/airlock/atmos,
/turf/open/floor/iron/dark/smooth_large,
/area/shuttle/personally_bought/people_mover)
"nC" = (
/obj/machinery/power/shuttle_engine/propulsion{
	dir = 8
	},
/obj/effect/turf_decal/stripes/line{
	dir = 8
	},
/obj/structure/disposalpipe/trunk{
	dir = 4
	},
/turf/open/floor/plating/airless,
/area/shuttle/personally_bought/people_mover)
"or" = (
/obj/structure/shelf,
/obj/effect/spawner/random/maintenance/no_decals,
/obj/effect/turf_decal/bot_white,
/turf/open/floor/iron/dark/smooth_large,
/area/shuttle/personally_bought/people_mover)
"ow" = (
/obj/machinery/portable_atmospherics/canister/oxygen,
/obj/machinery/atmospherics/components/unary/vent_scrubber/on/layer2{
	dir = 4
	},
/obj/effect/turf_decal/bot_white,
/obj/machinery/light/red/dim/directional/west,
/turf/open/floor/iron/dark/smooth_large,
/area/shuttle/personally_bought/people_mover)
"oI" = (
/obj/item/tether_anchor{
	anchored = 1
	},
/turf/closed/wall/mineral/titanium/nodiagonal,
/area/shuttle/personally_bought/people_mover)
"pf" = (
/obj/effect/turf_decal/delivery/white,
/obj/machinery/door/airlock/external,
/obj/effect/mapping_helpers/airlock/cyclelink_helper{
	dir = 1
	},
/obj/docking_port/mobile/personally_bought,
/obj/structure/fans/tiny,
/turf/open/floor/iron/dark/smooth_large,
/area/shuttle/personally_bought/people_mover)
"pg" = (
/obj/machinery/power/shuttle_engine/heater{
	dir = 8
	},
/obj/structure/window/reinforced/plasma/spawner/directional/east,
/obj/effect/turf_decal/stripes/line{
	dir = 4
	},
/turf/open/floor/plating/airless,
/area/shuttle/personally_bought/people_mover)
"pl" = (
/obj/structure/shelf,
/obj/effect/spawner/random/maintenance/no_decals/three,
/obj/effect/turf_decal/bot_white,
/turf/open/floor/iron/dark/smooth_large,
/area/shuttle/personally_bought/people_mover)
"pM" = (
/obj/effect/turf_decal/bot_white,
/obj/machinery/atmospherics/components/unary/portables_connector/visible/layer2{
	dir = 4
	},
/obj/machinery/portable_atmospherics/canister,
/turf/open/floor/iron/dark/smooth_large,
/area/shuttle/personally_bought/people_mover)
"pV" = (
/obj/structure/cable,
/obj/machinery/atmospherics/components/unary/vent_pump/on/layer4{
	dir = 4
	},
/obj/machinery/wall_healer/free/directional/west,
/turf/open/floor/iron/smooth,
/area/shuttle/personally_bought/people_mover)
"qy" = (
/obj/machinery/atmospherics/pipe/smart/manifold4w/scrubbers/hidden/layer2,
/obj/machinery/atmospherics/pipe/smart/manifold4w/supply/hidden/layer4,
/obj/structure/cable,
/obj/machinery/airalarm/directional/east,
/obj/effect/mapping_helpers/airalarm/all_access,
/turf/open/floor/catwalk_floor/iron_smooth,
/area/shuttle/personally_bought/people_mover)
"sa" = (
/obj/effect/turf_decal/bot_red,
/obj/machinery/holopad,
/obj/structure/cable,
/turf/open/floor/iron/dark/smooth_large,
/area/shuttle/personally_bought/people_mover)
"us" = (
/obj/machinery/atmospherics/pipe/smart/manifold4w/supply/hidden/layer4,
/obj/machinery/atmospherics/pipe/smart/manifold4w/scrubbers/hidden/layer2,
/obj/effect/turf_decal/delivery/white,
/obj/machinery/door/airlock/external,
/obj/effect/mapping_helpers/airlock/cyclelink_helper,
/turf/open/floor/iron/dark/smooth_large,
/area/shuttle/personally_bought/people_mover)
"ux" = (
/obj/structure/cable,
/obj/machinery/atmospherics/pipe/smart/manifold4w/scrubbers/hidden/layer2,
/obj/machinery/atmospherics/pipe/smart/manifold4w/supply/hidden/layer4,
/turf/open/floor/iron/smooth,
/area/shuttle/personally_bought/people_mover)
"uy" = (
/obj/structure/marker_beacon/olive,
/turf/closed/wall/mineral/plastitanium,
/area/shuttle/personally_bought/people_mover)
"uI" = (
/obj/machinery/atmospherics/components/unary/vent_scrubber/on/layer2{
	dir = 4
	},
/obj/structure/closet/crate,
/obj/effect/spawner/random/maintenance/no_decals/four,
/obj/effect/turf_decal/bot_white,
/turf/open/floor/iron/dark/smooth_large,
/area/shuttle/personally_bought/people_mover)
"vv" = (
/obj/machinery/power/shuttle_engine/propulsion{
	dir = 8
	},
/obj/machinery/atmospherics/components/unary/passive_vent/layer2{
	dir = 4
	},
/obj/effect/turf_decal/stripes/line{
	dir = 8
	},
/turf/open/floor/plating/airless,
/area/shuttle/personally_bought/people_mover)
"vU" = (
/obj/machinery/power/shuttle_engine/propulsion{
	dir = 8
	},
/obj/effect/turf_decal/stripes/line{
	dir = 8
	},
/turf/open/floor/plating/airless,
/area/shuttle/personally_bought/people_mover)
"xe" = (
/obj/structure/marker_beacon/olive,
/turf/closed/wall/mineral/titanium/nodiagonal,
/area/shuttle/personally_bought/people_mover)
"xj" = (
/obj/effect/turf_decal/stripes/line{
	dir = 4
	},
/obj/machinery/power/shuttle_engine/heater{
	dir = 8
	},
/obj/structure/window/reinforced/plasma/spawner/directional/east,
/obj/structure/disposalpipe/segment{
	dir = 4
	},
/turf/open/floor/plating/airless,
/area/shuttle/personally_bought/people_mover)
"xz" = (
/obj/structure/cable,
/obj/machinery/atmospherics/components/unary/vent_scrubber/on/layer2{
	dir = 8
	},
/turf/open/floor/iron/smooth,
/area/shuttle/personally_bought/people_mover)
"xN" = (
/obj/effect/spawner/structure/window/reinforced/shuttle,
/obj/structure/cable,
/obj/machinery/door/poddoor/preopen/personal_shuttle_windows,
/turf/open/floor/plating,
/area/shuttle/personally_bought/people_mover)
"zg" = (
/obj/machinery/atmospherics/pipe/smart/manifold4w/scrubbers/hidden/layer2,
/obj/machinery/atmospherics/pipe/smart/manifold4w/supply/hidden/layer4,
/obj/machinery/light/cold/directional/south,
/turf/open/floor/iron/smooth,
/area/shuttle/personally_bought/people_mover)
"Bq" = (
/obj/machinery/button/door/personal_shuttle_windows/directional/east,
/obj/machinery/atmospherics/components/unary/vent_pump/on/layer4{
	dir = 8
	},
/obj/structure/chair/comfy/shuttle{
	dir = 8
	},
/obj/effect/turf_decal/box/red/corners,
/obj/effect/turf_decal/box/red/corners{
	dir = 8
	},
/turf/open/floor/iron/dark/smooth_large,
/area/shuttle/personally_bought/people_mover)
"BK" = (
/obj/structure/railing/eva_handhold/directional/north,
/turf/closed/wall/mineral/plastitanium/nodiagonal,
/area/shuttle/personally_bought/people_mover)
"CB" = (
/obj/machinery/light/cold/directional/north,
/obj/machinery/digital_clock/directional/north,
/obj/machinery/atmospherics/components/unary/vent_pump/on/layer4,
/obj/structure/shelf,
/obj/effect/spawner/random/maintenance/no_decals/two,
/obj/effect/turf_decal/bot_white,
/turf/open/floor/iron/dark/smooth_large,
/area/shuttle/personally_bought/people_mover)
"Db" = (
/obj/machinery/computer/shuttle/personally_bought{
	dir = 1
	},
/obj/effect/turf_decal/bot_white,
/turf/open/floor/iron/dark/smooth_large,
/area/shuttle/personally_bought/people_mover)
"DE" = (
/obj/machinery/light/cold/directional/north,
/obj/effect/turf_decal/bot_white,
/obj/structure/disposalpipe/trunk{
	dir = 8
	},
/obj/machinery/disposal/bin,
/turf/open/floor/iron/dark/smooth_large,
/area/shuttle/personally_bought/people_mover)
"Es" = (
/obj/structure/shelf,
/obj/effect/turf_decal/bot_white,
/obj/structure/extinguisher_cabinet/directional/south,
/turf/open/floor/iron/dark/smooth_large,
/area/shuttle/personally_bought/people_mover)
"EW" = (
/obj/machinery/atmospherics/pipe/smart/manifold4w/scrubbers/hidden/layer2,
/obj/structure/closet/firecloset/shuttle,
/obj/effect/turf_decal/bot_white,
/turf/open/floor/iron/dark/smooth_large,
/area/shuttle/personally_bought/people_mover)
"Fl" = (
/obj/structure/marker_beacon/bronze,
/turf/closed/wall/mineral/titanium,
/area/shuttle/personally_bought/people_mover)
"Fw" = (
/turf/closed/wall/mineral/titanium/nodiagonal,
/area/shuttle/personally_bought/people_mover)
"FC" = (
/turf/closed/wall/mineral/plastitanium/nodiagonal,
/area/shuttle/personally_bought/people_mover)
"Gc" = (
/obj/machinery/atmospherics/pipe/smart/manifold4w/scrubbers/hidden/layer2,
/obj/machinery/atmospherics/pipe/smart/manifold4w/supply/hidden/layer4,
/obj/machinery/meter/layer4,
/turf/open/floor/iron/smooth,
/area/shuttle/personally_bought/people_mover)
"Gg" = (
/obj/structure/chair/comfy/shuttle,
/obj/structure/cable,
/obj/item/radio/intercom/directional/north,
/turf/open/floor/iron/smooth,
/area/shuttle/personally_bought/people_mover)
"GF" = (
/obj/structure/closet/crate/robust,
/obj/effect/spawner/random/maintenance/no_decals/two,
/obj/effect/turf_decal/bot_white,
/turf/open/floor/iron/dark/smooth_large,
/area/shuttle/personally_bought/people_mover)
"GK" = (
/obj/machinery/atmospherics/pipe/smart/manifold4w/scrubbers/hidden/layer2,
/obj/machinery/atmospherics/pipe/smart/manifold4w/supply/hidden/layer4,
/obj/machinery/meter/layer2,
/obj/structure/disposalpipe/segment{
	dir = 4
	},
/turf/open/floor/iron/smooth,
/area/shuttle/personally_bought/people_mover)
"HJ" = (
/obj/structure/marker_beacon/burgundy,
/turf/closed/wall/mineral/titanium/nodiagonal,
/area/shuttle/personally_bought/people_mover)
"HL" = (
/obj/machinery/modular_computer/preset/engineering{
	dir = 1
	},
/obj/structure/cable,
/obj/effect/turf_decal/bot_white,
/obj/structure/extinguisher_cabinet/directional/west,
/turf/open/floor/iron/dark/smooth_large,
/area/shuttle/personally_bought/people_mover)
"HN" = (
/obj/machinery/atmospherics/pipe/smart/manifold4w/scrubbers/hidden/layer2,
/obj/machinery/atmospherics/pipe/smart/manifold4w/supply/hidden/layer4,
/obj/structure/cable,
/turf/open/floor/catwalk_floor/iron_smooth,
/area/shuttle/personally_bought/people_mover)
"Ix" = (
/obj/machinery/atmospherics/pipe/smart/manifold4w/scrubbers/hidden/layer2,
/obj/machinery/atmospherics/pipe/smart/manifold4w/supply/hidden/layer4,
/obj/machinery/light/cold/directional/north,
/turf/open/floor/iron/smooth,
/area/shuttle/personally_bought/people_mover)
"IA" = (
/obj/machinery/light/cold/directional/north,
/obj/structure/chair/comfy/shuttle,
/obj/effect/turf_decal/box/red/corners,
/obj/effect/turf_decal/box/red/corners{
	dir = 4
	},
/turf/open/floor/iron/dark/smooth_large,
/area/shuttle/personally_bought/people_mover)
"Ki" = (
/obj/structure/cable,
/obj/machinery/atmospherics/pipe/smart/manifold4w/supply/hidden/layer4,
/obj/machinery/atmospherics/pipe/smart/manifold4w/scrubbers/hidden/layer2,
/turf/open/floor/iron/smooth,
/area/shuttle/personally_bought/people_mover)
"Lj" = (
/obj/machinery/atmospherics/components/unary/vent_pump/on/layer4{
	dir = 4
	},
/obj/machinery/recharge_station,
/obj/effect/turf_decal/bot_white,
/turf/open/floor/iron/dark/smooth_large,
/area/shuttle/personally_bought/people_mover)
"Lt" = (
/obj/structure/railing/eva_handhold/directional/north,
/turf/closed/wall/mineral/titanium/nodiagonal,
/area/shuttle/personally_bought/people_mover)
"LJ" = (
/obj/effect/turf_decal/bot_white,
/obj/machinery/atmospherics/components/unary/vent_pump/on/layer4{
	dir = 8
	},
/obj/structure/extinguisher_cabinet/directional/south,
/obj/structure/closet/firecloset/shuttle/tools,
/turf/open/floor/iron/dark/smooth_large,
/area/shuttle/personally_bought/people_mover)
"MF" = (
/turf/closed/wall/mineral/titanium,
/area/shuttle/personally_bought/people_mover)
"MT" = (
/obj/machinery/light_switch/directional/north,
/obj/structure/shelf,
/obj/effect/turf_decal/bot_white,
/turf/open/floor/iron/dark/smooth_large,
/area/shuttle/personally_bought/people_mover)
"NL" = (
/obj/machinery/atmospherics/pipe/smart/manifold4w/supply/hidden/layer4,
/obj/machinery/atmospherics/pipe/smart/manifold4w/scrubbers/hidden/layer2,
/obj/effect/turf_decal/delivery/white,
/obj/machinery/door/airlock/atmos,
/turf/open/floor/iron/dark/smooth_large,
/area/shuttle/personally_bought/people_mover)
"Ok" = (
/obj/machinery/atmospherics/components/unary/vent_scrubber/on/layer2{
	dir = 8
	},
/obj/structure/chair/comfy/shuttle{
	dir = 8
	},
/obj/effect/turf_decal/box/red/corners{
	dir = 1
	},
/obj/effect/turf_decal/box/red/corners{
	dir = 4
	},
/obj/structure/cable,
/turf/open/floor/iron/dark/smooth_large,
/area/shuttle/personally_bought/people_mover)
"Qc" = (
/obj/machinery/atmospherics/pipe/smart/manifold4w/supply/hidden/layer4,
/obj/machinery/atmospherics/pipe/smart/manifold4w/scrubbers/hidden/layer2,
/obj/structure/cable,
/turf/open/floor/catwalk_floor/iron_smooth,
/area/shuttle/personally_bought/people_mover)
"Qw" = (
/obj/machinery/atmospherics/pipe/smart/manifold4w/scrubbers/hidden/layer2,
/obj/machinery/atmospherics/pipe/smart/manifold4w/supply/hidden/layer4,
/turf/open/floor/iron/smooth,
/area/shuttle/personally_bought/people_mover)
"QF" = (
/obj/structure/railing/eva_handhold/directional/south,
/turf/closed/wall/mineral/titanium/nodiagonal,
/area/shuttle/personally_bought/people_mover)
"RY" = (
/obj/item/storage/toolbox/emergency,
/obj/item/binoculars,
/obj/item/trench_tool,
/obj/effect/turf_decal/bot_white,
/obj/machinery/light/warm/directional/south,
/obj/structure/shelf,
/turf/open/floor/iron/dark/smooth_large,
/area/shuttle/personally_bought/people_mover)
"Sd" = (
/obj/structure/table/reinforced,
/obj/machinery/recharger,
/obj/structure/secure_safe/directional/north,
/turf/open/floor/iron/dark/smooth_large,
/area/shuttle/personally_bought/people_mover)
"Tw" = (
/turf/template_noop,
/area/template_noop)
"TM" = (
/obj/machinery/atmospherics/pipe/smart/manifold4w/scrubbers/hidden/layer2,
/obj/machinery/atmospherics/pipe/smart/manifold4w/supply/hidden/layer4,
/turf/open/floor/catwalk_floor/iron_smooth,
/area/shuttle/personally_bought/people_mover)
"Vh" = (
/obj/machinery/atmospherics/pipe/smart/manifold4w/supply/hidden/layer4,
/obj/effect/turf_decal/delivery/white,
/obj/machinery/atmospherics/pipe/smart/manifold4w/scrubbers/hidden/layer2,
/obj/structure/cable,
/obj/machinery/door/airlock/command,
/turf/open/floor/iron/dark/smooth_large,
/area/shuttle/personally_bought/people_mover)
"Wc" = (
/obj/machinery/power/shuttle_engine/heater{
	dir = 8
	},
/obj/structure/window/reinforced/plasma/spawner/directional/east,
/obj/machinery/atmospherics/pipe/smart/manifold4w/scrubbers/hidden/layer2,
/obj/effect/turf_decal/stripes/line{
	dir = 4
	},
/turf/open/floor/plating/airless,
/area/shuttle/personally_bought/people_mover)
"WP" = (
/obj/effect/turf_decal/bot_white,
/obj/machinery/atmospherics/components/unary/portables_connector/visible/layer4{
	dir = 8
	},
/obj/machinery/portable_atmospherics/canister/air,
/obj/structure/extinguisher_cabinet/directional/north,
/turf/open/floor/iron/dark/smooth_large,
/area/shuttle/personally_bought/people_mover)
"WY" = (
/obj/machinery/power/apc/auto_name/directional/west,
/obj/effect/mapping_helpers/apc/cell_5k,
/obj/effect/mapping_helpers/apc/unlocked,
/obj/structure/cable,
/obj/structure/closet/crate/preopen,
/obj/effect/turf_decal/bot_white,
/turf/open/floor/iron/dark/smooth_large,
/area/shuttle/personally_bought/people_mover)
"ZI" = (
/obj/structure/chair/comfy/shuttle{
	dir = 1
	},
/obj/effect/turf_decal/box/red/corners{
	dir = 1
	},
/obj/effect/turf_decal/box/red/corners{
	dir = 8
	},
/turf/open/floor/iron/dark/smooth_large,
/area/shuttle/personally_bought/people_mover)

(1,1,1) = {"
mf
vv
FC
Tw
Tw
Tw
FC
vU
uy
"}
(2,1,1) = {"
FC
Wc
FC
nC
vU
vU
FC
pg
FC
"}
(3,1,1) = {"
BK
EW
FC
xj
ie
ie
FC
pM
hR
"}
(4,1,1) = {"
iX
Ix
np
GK
TM
Gc
NL
zg
iX
"}
(5,1,1) = {"
aL
WP
FC
DE
dR
or
FC
LJ
aL
"}
(6,1,1) = {"
HJ
Fw
Fw
GF
gV
Es
Fw
Fw
xe
"}
(7,1,1) = {"
Fw
MT
WY
uI
HN
Lj
Fw
ow
QF
"}
(8,1,1) = {"
Lt
CB
gV
gV
qy
Qw
us
dh
pf
"}
(9,1,1) = {"
HJ
Fw
Qc
ZI
Fw
Fw
Fw
Fw
xe
"}
(10,1,1) = {"
Fw
iJ
co
ae
Fw
ai
pV
HL
Fw
"}
(11,1,1) = {"
oI
IA
Ki
Ki
Vh
Ki
ux
RY
oI
"}
(12,1,1) = {"
Fw
pl
Ok
Bq
Fw
Sd
xz
jM
xN
"}
(13,1,1) = {"
Fw
Fw
xN
Fw
Fw
Fw
Gg
Db
xN
"}
(14,1,1) = {"
Fl
HJ
Tw
Tw
Tw
xN
sa
Fw
jx
"}
(15,1,1) = {"
Tw
Tw
Tw
Tw
Tw
Fw
xN
MF
Tw
"}
