//MAP CONVERTED BY dmm2tgm.py THIS HEADER COMMENT PREVENTS RECONVERSION, DO NOT REMOVE
"eb" = (
/obj/structure/shuttle_decoration/rcs/directional/north,
/obj/structure/shuttle_decoration/wall_plate/gold_foil,
/turf/closed/wall/mineral/nanocarbon/nodiagonal/primary_colour,
/area/shuttle/personally_bought/people_mover)
"ez" = (
/obj/machinery/door/airlock/spacer,
/obj/effect/mapping_helpers/airlock/cyclelink_helper,
/turf/open/floor/plating/nanocarbon,
/area/shuttle/personally_bought/people_mover)
"eF" = (
/turf/closed/wall/mineral/nanocarbon/nodiagonal/primary_colour,
/area/shuttle/personally_bought/people_mover)
"fI" = (
/obj/machinery/light/red/dim/directional/west,
/turf/open/floor/catwalk_floor/colony_fabricator/nanocarbon,
/area/shuttle/personally_bought/people_mover)
"gb" = (
/obj/machinery/atmospherics/components/unary/vent_scrubber/on/layer2{
	dir = 4
	},
/obj/structure/shuttle_decoration/liquid_tank/coolant,
/turf/open/floor/plating/nanocarbon,
/area/shuttle/personally_bought/people_mover)
"iv" = (
/obj/machinery/portable_atmospherics/canister/air,
/obj/machinery/atmospherics/components/unary/portables_connector/visible/layer4{
	dir = 1
	},
/turf/open/floor/plating/nanocarbon,
/area/shuttle/personally_bought/people_mover)
"jv" = (
/obj/structure/shuttle_decoration/radiator/directional/south,
/turf/closed/wall/mineral/nanocarbon/nodiagonal/black,
/area/shuttle/personally_bought/people_mover)
"ms" = (
/obj/structure/mineral_door/manual_colony_door/shuttle/interior,
/obj/structure/cable,
/obj/machinery/atmospherics/pipe/smart/manifold4w/supply/hidden/layer4,
/obj/machinery/atmospherics/pipe/smart/manifold4w/scrubbers/hidden/layer2,
/turf/open/floor/plating/nanocarbon,
/area/shuttle/personally_bought/people_mover)
"oO" = (
/turf/closed/wall/mineral/nanocarbon/secondary_colour,
/area/shuttle/personally_bought/people_mover)
"pH" = (
/obj/structure/shuttle_decoration/ladder/directional/north,
/turf/closed/wall/mineral/nanocarbon/nodiagonal/secondary_colour,
/area/shuttle/personally_bought/people_mover)
"pS" = (
/obj/structure/shuttle_decoration/wall_plate/gold_foil{
	dir = 8
	},
/turf/closed/wall/mineral/aluminum,
/area/shuttle/personally_bought/people_mover)
"rW" = (
/obj/structure/shuttle_decoration/bullbar/directional/east,
/turf/closed/wall/mineral/nanocarbon/nodiagonal/primary_colour,
/area/shuttle/personally_bought/people_mover)
"tC" = (
/obj/structure/shuttle_decoration/wall_plate/plastamic,
/turf/closed/wall/mineral/nanocarbon/nodiagonal/primary_colour,
/area/shuttle/personally_bought/people_mover)
"tE" = (
/obj/structure/shuttle_decoration/console/directional/south,
/turf/closed/wall/mineral/nanocarbon/nodiagonal/primary_colour,
/area/shuttle/personally_bought/people_mover)
"tG" = (
/obj/machinery/vending/wallmed/directional/north,
/obj/structure/closet/secure_closet/personal,
/turf/open/floor/plating/nanocarbon,
/area/shuttle/personally_bought/people_mover)
"uM" = (
/obj/structure/cable,
/obj/machinery/atmospherics/pipe/smart/manifold4w/supply/hidden/layer4,
/obj/machinery/atmospherics/pipe/smart/manifold4w/scrubbers/hidden/layer2,
/obj/structure/sink/cycler/directional/west,
/turf/open/floor/iron/colony/nanocarbon,
/area/shuttle/personally_bought/people_mover)
"wf" = (
/obj/structure/shuttle_decoration/radiator/directional/north,
/turf/closed/wall/mineral/nanocarbon/nodiagonal/black,
/area/shuttle/personally_bought/people_mover)
"wA" = (
/obj/machinery/exoscanner/shuttle_part/radio_dish/directional/east,
/turf/closed/wall/mineral/nanocarbon/nodiagonal/secondary_colour,
/area/shuttle/personally_bought/people_mover)
"yR" = (
/obj/effect/spawner/random/salvage/crate_only/civilian_supply,
/obj/machinery/atmospherics/components/unary/vent_pump/on/layer4,
/obj/machinery/airalarm/directional/west,
/obj/effect/mapping_helpers/airalarm/all_access,
/turf/open/floor/plating/nanocarbon,
/area/shuttle/personally_bought/people_mover)
"yZ" = (
/turf/closed/wall/mineral/nanocarbon/nodiagonal/black,
/area/shuttle/personally_bought/people_mover)
"zd" = (
/obj/structure/shuttle_decoration/wall_plate/armor{
	dir = 1
	},
/turf/closed/wall/mineral/nanocarbon/nodiagonal/black,
/area/shuttle/personally_bought/people_mover)
"zu" = (
/obj/machinery/portable_atmospherics/canister,
/obj/machinery/atmospherics/components/unary/portables_connector/visible/layer2{
	dir = 1
	},
/obj/machinery/light/blacklight/directional/east,
/turf/open/floor/plating/nanocarbon,
/area/shuttle/personally_bought/people_mover)
"Av" = (
/obj/machinery/computer/camera_advanced/shuttle_docker/personally_bought{
	view_range = 2;
	y_offset = 5;
	dir = 8
	},
/obj/item/radio/intercom/directional/east,
/obj/machinery/button/door/personal_shuttle_windows/directional/north,
/obj/machinery/atmospherics/components/unary/vent_scrubber/on/layer2{
	dir = 8
	},
/turf/open/floor/plating/nanocarbon,
/area/shuttle/personally_bought/people_mover)
"BV" = (
/obj/structure/shuttle_decoration/ladder/directional/south,
/turf/closed/wall/mineral/nanocarbon/nodiagonal/secondary_colour,
/area/shuttle/personally_bought/people_mover)
"BW" = (
/obj/structure/mineral_door/manual_colony_door/shuttle/interior,
/obj/machinery/atmospherics/pipe/smart/manifold4w/supply/hidden/layer4,
/obj/machinery/atmospherics/pipe/smart/manifold4w/scrubbers/hidden/layer2,
/turf/open/floor/plating/nanocarbon,
/area/shuttle/personally_bought/people_mover)
"CC" = (
/obj/machinery/wall_healer/free/directional/east,
/obj/machinery/atmospherics/pipe/smart/manifold4w/supply/hidden/layer4,
/obj/machinery/atmospherics/pipe/smart/manifold4w/scrubbers/hidden/layer2,
/turf/open/floor/iron/colony/texture/nanocarbon,
/area/shuttle/personally_bought/people_mover)
"CO" = (
/obj/machinery/atmospherics/pipe/smart/manifold4w/supply/hidden/layer4,
/obj/machinery/atmospherics/pipe/smart/manifold4w/scrubbers/hidden/layer2,
/obj/machinery/meter/layer2,
/turf/open/floor/iron/colony/nanocarbon,
/area/shuttle/personally_bought/people_mover)
"CU" = (
/obj/structure/shuttle_decoration/wall_plate/armor,
/obj/structure/shuttle_decoration/wall_plate/armor{
	dir = 1
	},
/turf/closed/wall/mineral/aluminum,
/area/shuttle/personally_bought/people_mover)
"DW" = (
/obj/machinery/modular_computer/preset/engineering{
	dir = 4
	},
/obj/structure/secure_safe/directional/west,
/turf/open/floor/plating/nanocarbon,
/area/shuttle/personally_bought/people_mover)
"Em" = (
/obj/structure/shuttle_decoration/wall_plate/gold_foil{
	dir = 8
	},
/obj/structure/shuttle_decoration/wall_plate/plastamic{
	dir = 4
	},
/turf/closed/wall/mineral/aluminum,
/area/shuttle/personally_bought/people_mover)
"Ev" = (
/obj/structure/shuttle_decoration/extinguisher/directional/north,
/obj/structure/shuttle_decoration/wall_plate/gold_foil,
/turf/closed/wall/mineral/nanocarbon/nodiagonal/secondary_colour,
/area/shuttle/personally_bought/people_mover)
"ER" = (
/obj/structure/shuttle_decoration/rcs/directional/north,
/turf/closed/wall/mineral/nanocarbon/nodiagonal/primary_colour,
/area/shuttle/personally_bought/people_mover)
"Fo" = (
/obj/structure/shuttle_decoration/extinguisher/directional/south,
/obj/structure/shuttle_decoration/wall_plate/gold_foil{
	dir = 1
	},
/turf/closed/wall/mineral/nanocarbon/nodiagonal/secondary_colour,
/area/shuttle/personally_bought/people_mover)
"Gm" = (
/obj/structure/chair/comfy/shuttle{
	dir = 4
	},
/turf/open/floor/iron/colony/nanocarbon,
/area/shuttle/personally_bought/people_mover)
"Hd" = (
/obj/structure/window/fulltile/salvage_shuttle,
/obj/machinery/door/poddoor/preopen/personal_shuttle_windows,
/turf/open/floor/plating/nanocarbon,
/area/shuttle/personally_bought/people_mover)
"HR" = (
/obj/machinery/digital_clock/directional/north,
/obj/structure/closet/sleeping_compartment,
/turf/open/floor/plating/nanocarbon,
/area/shuttle/personally_bought/people_mover)
"Im" = (
/obj/machinery/power/micro_reactor,
/obj/structure/cable,
/turf/open/floor/plating/nanocarbon,
/area/shuttle/personally_bought/people_mover)
"In" = (
/obj/structure/cable,
/obj/machinery/atmospherics/pipe/smart/manifold4w/supply/hidden/layer4,
/obj/machinery/atmospherics/pipe/smart/manifold4w/scrubbers/hidden/layer2,
/turf/open/floor/iron/colony/texture/nanocarbon,
/area/shuttle/personally_bought/people_mover)
"IH" = (
/obj/machinery/power/shuttle_engine/propulsion{
	dir = 8
	},
/obj/structure/engine_covers/thruster_nozzle{
	dir = 8
	},
/turf/open/floor/plating/nanocarbon/airless,
/area/shuttle/personally_bought/people_mover)
"IM" = (
/obj/structure/shuttle_decoration/wall_plate/plastamic{
	dir = 8
	},
/turf/closed/wall/mineral/aluminum,
/area/shuttle/personally_bought/people_mover)
"IP" = (
/turf/closed/wall/mineral/aluminum,
/area/shuttle/personally_bought/people_mover)
"Jd" = (
/obj/structure/shuttle_decoration/rcs/directional/south,
/turf/closed/wall/mineral/nanocarbon/nodiagonal/primary_colour,
/area/shuttle/personally_bought/people_mover)
"JK" = (
/turf/closed/wall/mineral/nanocarbon/nodiagonal/secondary_colour,
/area/shuttle/personally_bought/people_mover)
"KN" = (
/obj/structure/extinguisher_cabinet/directional/east,
/obj/machinery/atmospherics/components/unary/vent_pump/on/layer4,
/obj/machinery/atmospherics/pipe/smart/manifold4w/scrubbers/hidden/layer2,
/turf/open/floor/iron/colony/nanocarbon,
/area/shuttle/personally_bought/people_mover)
"LH" = (
/obj/structure/fans/tiny,
/obj/docking_port/mobile/personally_bought,
/obj/machinery/door/airlock/spacer,
/obj/effect/mapping_helpers/airlock/cyclelink_helper{
	dir = 1
	},
/turf/open/floor/plating/nanocarbon,
/area/shuttle/personally_bought/people_mover)
"Md" = (
/obj/structure/shuttle_decoration/wall_plate/armor,
/turf/closed/wall/mineral/nanocarbon/nodiagonal/black,
/area/shuttle/personally_bought/people_mover)
"Ow" = (
/obj/structure/shuttle_decoration/junction_box/directional/west,
/turf/closed/wall/mineral/aluminum,
/area/shuttle/personally_bought/people_mover)
"Pp" = (
/obj/structure/shelf,
/obj/item/storage/toolbox/emergency,
/obj/item/binoculars,
/obj/item/trench_tool,
/obj/machinery/atmospherics/components/unary/vent_pump/on/layer4{
	dir = 4
	},
/obj/machinery/light/warm/directional/west,
/turf/open/floor/plating/nanocarbon,
/area/shuttle/personally_bought/people_mover)
"PY" = (
/obj/machinery/suit_storage_unit/industrial/personal_shuttle,
/obj/machinery/atmospherics/pipe/smart/manifold4w/supply/hidden/layer4,
/turf/open/floor/plating/nanocarbon,
/area/shuttle/personally_bought/people_mover)
"Qm" = (
/obj/structure/closet/firecloset/shuttle,
/turf/open/floor/plating/nanocarbon,
/area/shuttle/personally_bought/people_mover)
"QI" = (
/obj/machinery/power/apc/auto_name/directional/south,
/obj/structure/cable,
/obj/machinery/atmospherics/pipe/smart/manifold4w/supply/hidden/layer4,
/obj/machinery/atmospherics/pipe/smart/manifold4w/scrubbers/hidden/layer2,
/obj/effect/mapping_helpers/apc/cell_5k,
/obj/effect/mapping_helpers/apc/unlocked,
/turf/open/floor/iron/colony/nanocarbon,
/area/shuttle/personally_bought/people_mover)
"RM" = (
/obj/machinery/computer/shuttle/personally_bought{
	dir = 8
	},
/turf/open/floor/plating/nanocarbon,
/area/shuttle/personally_bought/people_mover)
"RS" = (
/obj/machinery/power/shuttle_engine/heater{
	dir = 8
	},
/obj/structure/engine_covers/heater_cover{
	dir = 4
	},
/turf/open/floor/plating/nanocarbon/airless,
/area/shuttle/personally_bought/people_mover)
"TJ" = (
/obj/machinery/holopad,
/obj/machinery/atmospherics/pipe/smart/manifold4w/supply/hidden/layer4,
/obj/machinery/atmospherics/pipe/smart/manifold4w/scrubbers/hidden/layer2,
/turf/open/floor/iron/colony/nanocarbon,
/area/shuttle/personally_bought/people_mover)
"TO" = (
/obj/machinery/atmospherics/components/unary/vent_scrubber/on/layer2,
/obj/structure/sign/calendar/directional/east,
/obj/structure/table/reinforced,
/obj/machinery/coffeemaker,
/obj/machinery/light/warm/directional/north,
/turf/open/floor/plating/nanocarbon,
/area/shuttle/personally_bought/people_mover)
"Ur" = (
/obj/structure/extinguisher_cabinet/directional/south,
/obj/machinery/atmospherics/pipe/smart/manifold4w/supply/hidden/layer4,
/obj/machinery/atmospherics/pipe/smart/manifold4w/scrubbers/hidden/layer2,
/obj/structure/handrail/colony{
	dir = 1
	},
/turf/open/floor/iron/colony/nanocarbon,
/area/shuttle/personally_bought/people_mover)
"UW" = (
/obj/structure/shuttle_decoration/bullbar/directional/east,
/obj/structure/shuttle_decoration/headlight/directional/east,
/turf/closed/wall/mineral/nanocarbon/nodiagonal/primary_colour,
/area/shuttle/personally_bought/people_mover)
"Wb" = (
/obj/structure/closet/firecloset/shuttle/tools,
/obj/machinery/light/blacklight/directional/east,
/turf/open/floor/plating/nanocarbon,
/area/shuttle/personally_bought/people_mover)
"Wi" = (
/obj/structure/cable,
/obj/machinery/atmospherics/pipe/smart/manifold4w/supply/hidden/layer4,
/obj/machinery/atmospherics/pipe/smart/manifold4w/scrubbers/hidden/layer2,
/obj/machinery/meter/layer4,
/obj/effect/landmark/ship_captain_spawner,
/turf/open/floor/catwalk_floor/colony_fabricator/nanocarbon,
/area/shuttle/personally_bought/people_mover)
"Xs" = (
/obj/structure/shuttle_decoration/rcs/directional/south,
/obj/structure/shuttle_decoration/wall_plate/gold_foil{
	dir = 1
	},
/turf/closed/wall/mineral/nanocarbon/nodiagonal/primary_colour,
/area/shuttle/personally_bought/people_mover)
"Yj" = (
/obj/effect/turf_decal/stripes/white/line{
	dir = 4
	},
/turf/open/floor/plating/nanocarbon/exterior/black,
/area/shuttle/personally_bought/people_mover)
"YC" = (
/turf/template_noop,
/area/template_noop)
"YR" = (
/turf/closed/wall/mineral/nanocarbon/primary_colour,
/area/shuttle/personally_bought/people_mover)

(1,1,1) = {"
CU
Yj
Yj
CU
Yj
Yj
CU
"}
(2,1,1) = {"
zd
IH
IH
yZ
IH
IH
Md
"}
(3,1,1) = {"
wf
RS
RS
yZ
RS
RS
jv
"}
(4,1,1) = {"
eb
Qm
gb
Im
PY
iv
Xs
"}
(5,1,1) = {"
Ev
Wb
KN
Wi
CO
zu
Fo
"}
(6,1,1) = {"
pH
pS
IP
ms
Ow
Em
BV
"}
(7,1,1) = {"
tE
yR
uM
In
ez
fI
LH
"}
(8,1,1) = {"
eF
tG
QI
IP
IP
IM
eF
"}
(9,1,1) = {"
ER
HR
Ur
IP
Pp
DW
Jd
"}
(10,1,1) = {"
tC
TO
CC
BW
TJ
Gm
Hd
"}
(11,1,1) = {"
JK
JK
eF
eF
Av
RM
Hd
"}
(12,1,1) = {"
oO
wA
YC
rW
UW
Hd
YR
"}
