//MAP CONVERTED BY dmm2tgm.py THIS HEADER COMMENT PREVENTS RECONVERSION, DO NOT REMOVE
"ae" = (
/obj/structure/shuttle_decoration/wall_plate/nanocarbon/primary_colour{
	dir = 1
	},
/turf/closed/wall/mineral/nanocarbon/nodiagonal/primary_colour,
/area/shuttle/personally_bought/private_liner)
"am" = (
/obj/machinery/atmospherics/pipe/smart/manifold4w/supply/hidden/layer4,
/obj/machinery/atmospherics/pipe/smart/manifold4w/scrubbers/hidden/layer2,
/turf/open/floor/iron/colony/nanocarbon,
/area/shuttle/personally_bought/private_liner)
"bf" = (
/obj/machinery/modular_computer/preset/engineering{
	dir = 4
	},
/obj/structure/cable,
/turf/open/floor/plating/nanocarbon,
/area/shuttle/personally_bought/private_liner)
"bg" = (
/turf/open/floor/catwalk_floor/colony_fabricator/nanocarbon,
/area/shuttle/personally_bought/private_liner)
"bl" = (
/obj/machinery/door/poddoor/preopen/personal_bay_two,
/obj/machinery/atmos_shield_gen/active{
	dir = 4
	},
/turf/open/floor/plating/nanocarbon,
/area/shuttle/personally_bought/private_liner)
"bQ" = (
/obj/structure/extinguisher_cabinet/directional/east,
/turf/open/floor/plating/aluminum,
/area/shuttle/personally_bought/private_liner)
"bU" = (
/obj/structure/shuttle_decoration/extinguisher/directional/south,
/obj/structure/shuttle_decoration/wall_plate/gold_foil{
	dir = 1
	},
/turf/closed/wall/mineral/nanocarbon/nodiagonal/primary_colour,
/area/shuttle/personally_bought/private_liner)
"cH" = (
/obj/structure/shuttle_decoration/bullbar/directional/north,
/turf/closed/wall/mineral/nanocarbon/nodiagonal/primary_colour,
/area/shuttle/personally_bought/private_liner)
"cP" = (
/obj/structure/shuttle_decoration/rcs/directional/south,
/obj/structure/shuttle_decoration/wall_plate/gold_foil{
	dir = 1
	},
/turf/closed/wall/mineral/nanocarbon/nodiagonal/primary_colour,
/area/shuttle/personally_bought/private_liner)
"dc" = (
/obj/structure/shuttle_decoration/junction_box/directional/south,
/obj/structure/shuttle_decoration/wall_plate/nanocarbon/secondary_colour{
	dir = 1
	},
/turf/closed/wall/mineral/nanocarbon/nodiagonal/secondary_colour,
/area/shuttle/personally_bought/private_liner)
"dP" = (
/obj/machinery/atmospherics/pipe/smart/manifold4w/supply/hidden/layer4,
/obj/machinery/atmospherics/pipe/smart/manifold4w/scrubbers/hidden/layer2,
/obj/structure/mineral_door/manual_colony_door/shuttle,
/turf/open/floor/plating/nanocarbon,
/area/shuttle/personally_bought/private_liner)
"ea" = (
/obj/structure/shuttle_decoration/ladder/directional/south,
/turf/closed/wall/mineral/nanocarbon/nodiagonal/primary_colour,
/area/shuttle/personally_bought/private_liner)
"eb" = (
/obj/machinery/wall_healer/free/directional/south,
/obj/machinery/light/warm/directional/south,
/obj/machinery/atmospherics/pipe/smart/manifold4w/supply/hidden/layer4,
/obj/machinery/atmospherics/pipe/smart/manifold4w/scrubbers/hidden/layer2,
/obj/structure/cable,
/turf/open/floor/catwalk_floor/colony_fabricator/nanocarbon,
/area/shuttle/personally_bought/private_liner)
"fb" = (
/obj/machinery/suit_storage_unit/industrial/personal_shuttle,
/obj/machinery/atmospherics/pipe/smart/manifold4w/supply/hidden/layer4,
/turf/open/floor/plating/nanocarbon,
/area/shuttle/personally_bought/private_liner)
"fh" = (
/obj/effect/spawner/random/salvage/crate_only/civilian_supply,
/turf/open/floor/plating/nanocarbon,
/area/shuttle/personally_bought/private_liner)
"fG" = (
/obj/machinery/suit_storage_unit/industrial/personal_shuttle,
/turf/open/floor/plating/aluminum,
/area/shuttle/personally_bought/private_liner)
"gM" = (
/obj/structure/shuttle_decoration/wall_plate/nanocarbon/primary_colour,
/turf/closed/wall/mineral/nanocarbon/nodiagonal/primary_colour,
/area/shuttle/personally_bought/private_liner)
"hy" = (
/obj/machinery/door/poddoor/preopen/personal_bay_two,
/obj/machinery/atmos_shield_gen/active{
	dir = 8
	},
/turf/open/floor/plating/nanocarbon,
/area/shuttle/personally_bought/private_liner)
"ic" = (
/obj/machinery/computer/mech_bay_power_console{
	dir = 4
	},
/turf/open/floor/plating/nanocarbon,
/area/shuttle/personally_bought/private_liner)
"ig" = (
/obj/machinery/power/shuttle_engine/propulsion{
	dir = 8
	},
/obj/structure/engine_covers/thruster_nozzle{
	dir = 8
	},
/turf/open/floor/plating/nanocarbon/airless,
/area/shuttle/personally_bought/private_liner)
"iB" = (
/obj/structure/shelf,
/obj/item/storage/toolbox/emergency,
/obj/item/binoculars,
/obj/item/trench_tool,
/obj/machinery/button/door/personal_shuttle_windows/directional/north,
/obj/structure/secure_safe/directional/west,
/turf/open/floor/plating/nanocarbon,
/area/shuttle/personally_bought/private_liner)
"iP" = (
/obj/machinery/atmospherics/pipe/smart/manifold4w/supply/hidden/layer4,
/obj/machinery/atmospherics/pipe/smart/manifold4w/scrubbers/hidden/layer2,
/turf/open/floor/catwalk_floor/colony_fabricator/nanocarbon,
/area/shuttle/personally_bought/private_liner)
"jj" = (
/obj/structure/window/fulltile/salvage_shuttle,
/obj/machinery/door/poddoor/preopen/personal_shuttle_windows,
/turf/open/floor/plating/nanocarbon,
/area/shuttle/personally_bought/private_liner)
"kd" = (
/obj/structure/mineral_door/manual_colony_door/shuttle/interior,
/obj/machinery/atmospherics/pipe/smart/manifold4w/supply/hidden/layer4,
/obj/machinery/atmospherics/pipe/smart/manifold4w/scrubbers/hidden/layer2,
/turf/open/floor/plating/nanocarbon,
/area/shuttle/personally_bought/private_liner)
"km" = (
/obj/effect/mapping_helpers/airalarm/all_access,
/obj/machinery/atmospherics/pipe/smart/manifold4w/supply/hidden/layer4,
/obj/machinery/atmospherics/pipe/smart/manifold4w/scrubbers/hidden/layer2,
/turf/open/floor/iron/colony/nanocarbon,
/area/shuttle/personally_bought/private_liner)
"kS" = (
/obj/structure/shuttle_decoration/wall_plate/armor{
	dir = 1
	},
/turf/closed/wall/mineral/nanocarbon/nodiagonal/black,
/area/shuttle/personally_bought/private_liner)
"mp" = (
/obj/effect/spawner/random/salvage/container_or_crate_or_cargo/salvage,
/turf/open/floor/plating/aluminum,
/area/shuttle/personally_bought/private_liner)
"mM" = (
/obj/machinery/light/red/directional/north,
/obj/effect/spawner/random/salvage/container_or_crate_or_cargo/salvage,
/turf/open/floor/plating/aluminum,
/area/shuttle/personally_bought/private_liner)
"mP" = (
/obj/structure/chair/comfy/shuttle{
	dir = 4
	},
/obj/machinery/atmospherics/components/unary/vent_scrubber/on/layer2,
/turf/open/floor/iron/colony/white/texture/nanocarbon,
/area/shuttle/personally_bought/private_liner)
"oO" = (
/obj/machinery/door/poddoor/preopen/personal_bay_one,
/turf/open/floor/plating/nanocarbon,
/area/shuttle/personally_bought/private_liner)
"pn" = (
/obj/machinery/atmospherics/components/unary/vent_pump/on/layer4{
	dir = 1
	},
/turf/open/floor/iron/colony/bolts/nanocarbon,
/area/shuttle/personally_bought/private_liner)
"qV" = (
/obj/machinery/door/airlock/spacer,
/obj/effect/mapping_helpers/airlock/cyclelink_helper,
/turf/open/floor/plating/nanocarbon,
/area/shuttle/personally_bought/private_liner)
"rx" = (
/obj/structure/shuttle_decoration/bullbar/directional/south,
/turf/closed/wall/mineral/nanocarbon/nodiagonal/secondary_colour,
/area/shuttle/personally_bought/private_liner)
"rC" = (
/turf/closed/wall/mineral/aluminum,
/area/shuttle/personally_bought/private_liner)
"rS" = (
/turf/closed/wall/mineral/nanocarbon/nodiagonal/black,
/area/shuttle/personally_bought/private_liner)
"st" = (
/turf/open/floor/plating/aluminum,
/area/shuttle/personally_bought/private_liner)
"sF" = (
/obj/structure/tank_dispenser,
/turf/open/floor/plating/aluminum,
/area/shuttle/personally_bought/private_liner)
"sZ" = (
/obj/structure/shuttle_decoration/rcs/directional/north,
/obj/structure/shuttle_decoration/wall_plate/gold_foil,
/turf/closed/wall/mineral/nanocarbon/nodiagonal/primary_colour,
/area/shuttle/personally_bought/private_liner)
"tf" = (
/obj/machinery/computer/crew{
	dir = 4
	},
/obj/machinery/light/warm/directional/west,
/obj/structure/extinguisher_cabinet/directional/west,
/turf/open/floor/plating/nanocarbon,
/area/shuttle/personally_bought/private_liner)
"tm" = (
/obj/structure/shuttle_decoration/extinguisher/directional/south,
/turf/closed/wall/mineral/nanocarbon/nodiagonal/primary_colour,
/area/shuttle/personally_bought/private_liner)
"tN" = (
/obj/structure/shuttle_decoration/aux_engine/directional/east,
/turf/closed/wall/mineral/nanocarbon/nodiagonal/primary_colour,
/area/shuttle/personally_bought/private_liner)
"tY" = (
/obj/machinery/atmospherics/components/unary/vent_scrubber/on/layer2{
	dir = 8
	},
/obj/machinery/atmospherics/pipe/smart/manifold4w/supply/hidden/layer4,
/turf/open/floor/catwalk_floor/colony_fabricator/nanocarbon,
/area/shuttle/personally_bought/private_liner)
"tZ" = (
/obj/machinery/atmospherics/components/unary/vent_pump/on/layer4{
	dir = 8
	},
/turf/open/floor/iron/colony/nanocarbon,
/area/shuttle/personally_bought/private_liner)
"ul" = (
/obj/effect/spawner/random/engineering/atmospherics_portable,
/turf/open/floor/plating/aluminum,
/area/shuttle/personally_bought/private_liner)
"vf" = (
/obj/machinery/door/poddoor/preopen/personal_bay_one,
/obj/machinery/button/door/personal_shuttle_bay_one/directional/north,
/obj/machinery/atmos_shield_gen/active{
	dir = 2
	},
/turf/open/floor/plating/nanocarbon,
/area/shuttle/personally_bought/private_liner)
"vh" = (
/obj/structure/railing{
	dir = 1
	},
/turf/open/floor/iron/colony/bolts/nanocarbon,
/area/shuttle/personally_bought/private_liner)
"vq" = (
/obj/machinery/button/door/personal_shuttle_bay_one/directional/east,
/obj/machinery/portable_atmospherics/canister/oxygen,
/turf/open/floor/plating/aluminum,
/area/shuttle/personally_bought/private_liner)
"vJ" = (
/obj/machinery/portable_atmospherics/canister/air,
/obj/machinery/atmospherics/components/unary/portables_connector/visible/layer4{
	dir = 1
	},
/turf/open/floor/plating/nanocarbon,
/area/shuttle/personally_bought/private_liner)
"vM" = (
/obj/structure/shuttle_decoration/junction_box/directional/west,
/turf/closed/wall/mineral/aluminum,
/area/shuttle/personally_bought/private_liner)
"vN" = (
/obj/effect/landmark/ship_captain_spawner,
/obj/machinery/atmospherics/pipe/smart/manifold4w/supply/hidden/layer4,
/obj/machinery/atmospherics/pipe/smart/manifold4w/scrubbers/hidden/layer2,
/turf/open/floor/catwalk_floor/colony_fabricator/nanocarbon,
/area/shuttle/personally_bought/private_liner)
"wn" = (
/obj/machinery/holopad,
/obj/machinery/atmospherics/pipe/smart/manifold4w/scrubbers/hidden/layer2,
/turf/open/floor/iron/colony/white/nanocarbon,
/area/shuttle/personally_bought/private_liner)
"wI" = (
/obj/structure/extinguisher_cabinet/directional/east,
/obj/machinery/atmospherics/components/unary/vent_pump/on/layer4,
/obj/machinery/atmospherics/pipe/smart/manifold4w/scrubbers/hidden/layer2,
/turf/open/floor/iron/colony/nanocarbon,
/area/shuttle/personally_bought/private_liner)
"zu" = (
/obj/structure/chair/comfy/shuttle{
	dir = 8
	},
/turf/open/floor/plating/nanocarbon,
/area/shuttle/personally_bought/private_liner)
"zT" = (
/obj/structure/shuttle_decoration/wall_plate/nanocarbon/secondary_colour{
	dir = 1
	},
/turf/closed/wall/mineral/nanocarbon/nodiagonal/secondary_colour,
/area/shuttle/personally_bought/private_liner)
"Aq" = (
/obj/machinery/door/poddoor/preopen/personal_bay_one,
/obj/machinery/atmos_shield_gen/active{
	dir = 1
	},
/obj/machinery/button/door/personal_shuttle_bay_one/directional/south,
/turf/open/floor/plating/nanocarbon,
/area/shuttle/personally_bought/private_liner)
"AG" = (
/turf/open/floor/plating/nanocarbon,
/area/shuttle/personally_bought/private_liner)
"BU" = (
/obj/structure/closet/firecloset/shuttle,
/turf/open/floor/plating/nanocarbon,
/area/shuttle/personally_bought/private_liner)
"Ct" = (
/obj/structure/shuttle_decoration/rcs/directional/south,
/turf/closed/wall/mineral/nanocarbon/nodiagonal/secondary_colour,
/area/shuttle/personally_bought/private_liner)
"DH" = (
/obj/machinery/power/apc/auto_name/directional/east,
/obj/effect/mapping_helpers/apc/unlocked,
/obj/effect/mapping_helpers/apc/cell_5k,
/obj/structure/chair/comfy/shuttle{
	dir = 8
	},
/obj/machinery/atmospherics/components/unary/vent_pump/on/layer4,
/obj/machinery/atmospherics/pipe/smart/manifold4w/scrubbers/hidden/layer2,
/obj/structure/cable,
/turf/open/floor/iron/colony/white/texture/nanocarbon,
/area/shuttle/personally_bought/private_liner)
"DI" = (
/obj/structure/closet/firecloset/shuttle/tools,
/obj/machinery/light/blacklight/directional/east,
/turf/open/floor/plating/nanocarbon,
/area/shuttle/personally_bought/private_liner)
"DN" = (
/obj/structure/shuttle_decoration/bullbar/directional/south,
/turf/closed/wall/mineral/nanocarbon/nodiagonal/primary_colour,
/area/shuttle/personally_bought/private_liner)
"FD" = (
/obj/structure/shuttle_decoration/rcs/directional/north,
/turf/closed/wall/mineral/nanocarbon/nodiagonal/secondary_colour,
/area/shuttle/personally_bought/private_liner)
"GB" = (
/obj/structure/shuttle_decoration/wall_plate/armor,
/obj/structure/shuttle_decoration/wall_plate/armor{
	dir = 1
	},
/turf/closed/wall/mineral/aluminum,
/area/shuttle/personally_bought/private_liner)
"GR" = (
/obj/effect/spawner/random/salvage/crate_only/salvage,
/turf/open/floor/plating/nanocarbon,
/area/shuttle/personally_bought/private_liner)
"HV" = (
/obj/structure/shuttle_decoration/extinguisher/directional/north,
/turf/closed/wall/mineral/nanocarbon/nodiagonal/primary_colour,
/area/shuttle/personally_bought/private_liner)
"If" = (
/obj/machinery/button/door/personal_shuttle_windows/directional/south,
/obj/machinery/light/warm/directional/south,
/obj/structure/closet/sleeping_compartment,
/turf/open/floor/plating/nanocarbon,
/area/shuttle/personally_bought/private_liner)
"Ir" = (
/obj/structure/shuttle_decoration/wall_plate/gold_foil{
	dir = 8
	},
/obj/structure/shuttle_decoration/wall_plate/plastamic{
	dir = 4
	},
/turf/closed/wall/mineral/aluminum,
/area/shuttle/personally_bought/private_liner)
"Jh" = (
/obj/structure/shuttle_decoration/wall_plate/plastamic{
	dir = 8
	},
/turf/closed/wall/mineral/aluminum,
/area/shuttle/personally_bought/private_liner)
"JA" = (
/obj/structure/shuttle_decoration/wall_plate/nanocarbon/secondary_colour,
/turf/closed/wall/mineral/nanocarbon/nodiagonal/secondary_colour,
/area/shuttle/personally_bought/private_liner)
"JC" = (
/obj/structure/table/reinforced,
/obj/machinery/coffeemaker,
/turf/open/floor/plating/nanocarbon,
/area/shuttle/personally_bought/private_liner)
"JH" = (
/obj/structure/railing{
	dir = 1
	},
/obj/effect/spawner/random/salvage/crate_only/civilian_supply,
/turf/open/floor/plating/nanocarbon,
/area/shuttle/personally_bought/private_liner)
"Kc" = (
/obj/structure/shuttle_decoration/headlight/directional/east,
/turf/closed/wall/mineral/nanocarbon/nodiagonal/primary_colour,
/area/shuttle/personally_bought/private_liner)
"Kk" = (
/obj/structure/mineral_door/manual_colony_door/shuttle/interior,
/obj/structure/cable,
/obj/machinery/atmospherics/pipe/smart/manifold4w/supply/hidden/layer4,
/obj/machinery/atmospherics/pipe/smart/manifold4w/scrubbers/hidden/layer2,
/turf/open/floor/plating/nanocarbon,
/area/shuttle/personally_bought/private_liner)
"KF" = (
/turf/template_noop,
/area/template_noop)
"KG" = (
/obj/machinery/button/door/personal_shuttle_bay_two/directional/north,
/obj/structure/shelf,
/obj/item/mecha_parts/mecha_equipment/hydraulic_clamp,
/obj/item/mecha_parts/mecha_equipment/mining_scanner,
/obj/item/mecha_parts/mecha_equipment/drill,
/turf/open/floor/plating/nanocarbon,
/area/shuttle/personally_bought/private_liner)
"KO" = (
/obj/machinery/vending/wallmed/directional/north,
/obj/machinery/modular_computer/preset/engineering{
	dir = 2
	},
/obj/structure/cable,
/turf/open/floor/plating/nanocarbon,
/area/shuttle/personally_bought/private_liner)
"KY" = (
/obj/structure/shuttle_decoration/wall_plate/nanocarbon/diagonal/primary_colour{
	dir = 9
	},
/turf/closed/wall/mineral/nanocarbon/primary_colour,
/area/shuttle/personally_bought/private_liner)
"Lc" = (
/obj/structure/shuttle_decoration/wall_plate/gold_foil{
	dir = 8
	},
/turf/closed/wall/mineral/aluminum,
/area/shuttle/personally_bought/private_liner)
"Lq" = (
/obj/machinery/mech_bay_recharge_port,
/turf/open/floor/plating/nanocarbon,
/area/shuttle/personally_bought/private_liner)
"LQ" = (
/obj/structure/chair/comfy/shuttle{
	dir = 8
	},
/obj/structure/railing{
	dir = 1
	},
/obj/structure/extinguisher_cabinet/directional/east,
/turf/open/floor/plating/nanocarbon,
/area/shuttle/personally_bought/private_liner)
"LV" = (
/obj/machinery/light/red/dim/directional/west,
/obj/structure/closet/emcloset/anchored,
/turf/open/floor/plating/nanocarbon,
/area/shuttle/personally_bought/private_liner)
"Mx" = (
/obj/structure/shuttle_decoration/bullbar/directional/south,
/obj/structure/shuttle_decoration/junction_box/directional/north,
/turf/closed/wall/mineral/nanocarbon/nodiagonal/primary_colour,
/area/shuttle/personally_bought/private_liner)
"MM" = (
/turf/closed/wall/mineral/nanocarbon/nodiagonal/secondary_colour,
/area/shuttle/personally_bought/private_liner)
"NC" = (
/obj/effect/turf_decal/stripes/white/line{
	dir = 4
	},
/turf/open/floor/plating/nanocarbon/exterior/black,
/area/shuttle/personally_bought/private_liner)
"Os" = (
/turf/closed/wall/mineral/nanocarbon/nodiagonal/primary_colour,
/area/shuttle/personally_bought/private_liner)
"Ov" = (
/obj/structure/shuttle_decoration/radiator/directional/south,
/turf/closed/wall/mineral/nanocarbon/nodiagonal/black,
/area/shuttle/personally_bought/private_liner)
"OC" = (
/obj/structure/shuttle_decoration/wall_plate/armor,
/turf/closed/wall/mineral/nanocarbon/nodiagonal/black,
/area/shuttle/personally_bought/private_liner)
"OX" = (
/obj/structure/shuttle_decoration/radiator/directional/north,
/turf/closed/wall/mineral/nanocarbon/nodiagonal/black,
/area/shuttle/personally_bought/private_liner)
"Po" = (
/obj/structure/cable,
/obj/machinery/atmospherics/pipe/smart/manifold4w/supply/hidden/layer4,
/obj/machinery/atmospherics/pipe/smart/manifold4w/scrubbers/hidden/layer2,
/obj/machinery/meter/layer4,
/obj/effect/landmark/ship_captain_spawner,
/turf/open/floor/catwalk_floor/colony_fabricator/nanocarbon,
/area/shuttle/personally_bought/private_liner)
"Py" = (
/obj/structure/mineral_door/manual_colony_door/shuttle/interior,
/obj/machinery/atmospherics/pipe/smart/manifold4w/supply/hidden/layer4,
/obj/machinery/atmospherics/pipe/smart/manifold4w/scrubbers/hidden/layer2,
/obj/structure/cable,
/turf/open/floor/plating/nanocarbon,
/area/shuttle/personally_bought/private_liner)
"PT" = (
/obj/machinery/power/micro_reactor,
/obj/structure/cable,
/turf/open/floor/plating/nanocarbon,
/area/shuttle/personally_bought/private_liner)
"Qy" = (
/obj/machinery/atmospherics/pipe/smart/manifold4w/supply/hidden/layer4,
/obj/machinery/atmospherics/pipe/smart/manifold4w/scrubbers/hidden/layer2,
/obj/machinery/meter/layer2,
/turf/open/floor/iron/colony/nanocarbon,
/area/shuttle/personally_bought/private_liner)
"RA" = (
/obj/structure/shuttle_decoration/extinguisher/directional/north,
/obj/structure/shuttle_decoration/wall_plate/gold_foil,
/turf/closed/wall/mineral/nanocarbon/nodiagonal/primary_colour,
/area/shuttle/personally_bought/private_liner)
"RH" = (
/obj/vehicle/sealed/mecha/ripley/mk2,
/turf/open/floor/plating/nanocarbon,
/area/shuttle/personally_bought/private_liner)
"RQ" = (
/obj/machinery/suit_storage_unit/industrial/personal_shuttle/heavy,
/obj/machinery/light/warm/directional/north,
/turf/open/floor/plating/aluminum,
/area/shuttle/personally_bought/private_liner)
"Ti" = (
/obj/machinery/power/shuttle_engine/heater{
	dir = 8
	},
/obj/structure/engine_covers/heater_cover{
	dir = 4
	},
/turf/open/floor/plating/nanocarbon/airless,
/area/shuttle/personally_bought/private_liner)
"TL" = (
/obj/machinery/portable_atmospherics/canister/oxygen,
/obj/machinery/light/warm/directional/south,
/turf/open/floor/plating/aluminum,
/area/shuttle/personally_bought/private_liner)
"Vt" = (
/obj/machinery/atmospherics/pipe/smart/manifold4w/supply/hidden/layer4,
/obj/machinery/atmospherics/pipe/smart/manifold4w/scrubbers/hidden/layer2,
/obj/structure/cable,
/turf/open/floor/iron/colony/nanocarbon,
/area/shuttle/personally_bought/private_liner)
"VJ" = (
/obj/machinery/computer/shuttle/personally_bought{
	dir = 8
	},
/obj/item/radio/intercom/directional/east,
/turf/open/floor/plating/nanocarbon,
/area/shuttle/personally_bought/private_liner)
"Wu" = (
/obj/machinery/light/red/directional/south,
/turf/open/floor/plating/aluminum,
/area/shuttle/personally_bought/private_liner)
"Xf" = (
/obj/machinery/atmospherics/components/unary/vent_scrubber/on/layer2{
	dir = 1
	},
/turf/open/floor/iron/colony/bolts/nanocarbon,
/area/shuttle/personally_bought/private_liner)
"Xu" = (
/obj/machinery/portable_atmospherics/canister,
/obj/machinery/atmospherics/components/unary/portables_connector/visible/layer2{
	dir = 1
	},
/obj/machinery/light/blacklight/directional/east,
/turf/open/floor/plating/nanocarbon,
/area/shuttle/personally_bought/private_liner)
"Xy" = (
/obj/machinery/atmospherics/components/unary/vent_scrubber/on/layer2{
	dir = 4
	},
/obj/structure/shuttle_decoration/liquid_tank/coolant,
/turf/open/floor/plating/nanocarbon,
/area/shuttle/personally_bought/private_liner)
"Yh" = (
/obj/machinery/computer/camera_advanced/shuttle_docker/personally_bought{
	x_offset = -4;
	y_offset = 5;
	view_range = 4;
	dir = 8
	},
/turf/open/floor/plating/nanocarbon,
/area/shuttle/personally_bought/private_liner)
"Yr" = (
/obj/structure/closet/sleeping_compartment,
/turf/open/floor/plating/nanocarbon,
/area/shuttle/personally_bought/private_liner)
"YJ" = (
/obj/effect/spawner/random/salvage/container_or_crate_or_cargo/salvage,
/turf/open/floor/plating/nanocarbon,
/area/shuttle/personally_bought/private_liner)
"YM" = (
/obj/docking_port/mobile/personally_bought,
/obj/machinery/door/airlock/spacer,
/obj/effect/mapping_helpers/airlock/cyclelink_helper{
	dir = 1
	},
/turf/open/floor/plating/nanocarbon,
/area/shuttle/personally_bought/private_liner)
"ZM" = (
/obj/machinery/atmospherics/pipe/smart/manifold4w/supply/hidden/layer4,
/obj/machinery/atmospherics/pipe/smart/manifold4w/scrubbers/hidden/layer2,
/obj/structure/cable,
/turf/open/floor/catwalk_floor/colony_fabricator/nanocarbon,
/area/shuttle/personally_bought/private_liner)

(1,1,1) = {"
KF
KF
GB
NC
NC
GB
NC
NC
GB
"}
(2,1,1) = {"
KF
KF
kS
ig
ig
rS
ig
ig
OC
"}
(3,1,1) = {"
KF
KF
OX
Ti
Ti
rS
Ti
Ti
Ov
"}
(4,1,1) = {"
KF
KF
sZ
BU
Xy
PT
fb
vJ
cP
"}
(5,1,1) = {"
KF
KF
RA
DI
wI
Po
Qy
Xu
bU
"}
(6,1,1) = {"
KY
Os
Os
Lc
rC
Kk
vM
Ir
ea
"}
(7,1,1) = {"
ae
iB
tf
bf
jj
eb
rC
LV
Os
"}
(8,1,1) = {"
jj
mP
wn
DH
Py
ZM
qV
bg
YM
"}
(9,1,1) = {"
jj
Yh
VJ
rC
rC
Py
rC
Jh
Os
"}
(10,1,1) = {"
Kc
jj
Os
rC
KO
Vt
JH
fh
gM
"}
(11,1,1) = {"
KF
KF
ae
Lq
ic
iP
pn
JC
jj
"}
(12,1,1) = {"
KF
KF
bl
RH
AG
vN
vh
If
rx
"}
(13,1,1) = {"
KF
KF
hy
AG
GR
km
Xf
Yr
jj
"}
(14,1,1) = {"
KF
KF
zT
KG
YJ
am
LQ
zu
JA
"}
(15,1,1) = {"
KF
KF
cH
rC
rC
kd
rC
vM
DN
"}
(16,1,1) = {"
KF
KF
jj
fG
mp
iP
st
sF
jj
"}
(17,1,1) = {"
KF
KF
cH
RQ
bQ
iP
vq
TL
Mx
"}
(18,1,1) = {"
KF
KF
dc
rC
rC
dP
rC
rC
MM
"}
(19,1,1) = {"
KF
KF
FD
mM
mp
iP
mp
Wu
Ct
"}
(20,1,1) = {"
KF
KF
HV
ul
mp
tY
st
mp
tm
"}
(21,1,1) = {"
KF
KF
tN
Os
AG
tZ
AG
Os
tN
"}
(22,1,1) = {"
KF
KF
KF
Kc
vf
oO
Aq
Kc
KF
"}
