//MAP CONVERTED BY dmm2tgm.py THIS HEADER COMMENT PREVENTS RECONVERSION, DO NOT REMOVE
"ad" = (
/obj/machinery/atmospherics/components/unary/vent_pump/on/layer4{
	dir = 4
	},
/obj/machinery/light/red/directional/south,
/obj/machinery/button/door/personal_shuttle_bay_one/directional/west,
/turf/open/floor/plating/nanocarbon,
/area/shuttle/personally_bought/mining_hub)
"ar" = (
/obj/structure/shuttle_decoration/rcs/directional/south,
/turf/closed/wall/mineral/nanocarbon/nodiagonal/primary_colour,
/area/shuttle/personally_bought/mining_hub)
"bp" = (
/obj/machinery/modular_computer/preset/engineering,
/obj/structure/cable,
/turf/open/floor/plating/nanocarbon,
/area/shuttle/personally_bought/mining_hub)
"bN" = (
/obj/structure/window/fulltile/salvage_shuttle,
/obj/machinery/door/poddoor/preopen/personal_shuttle_windows,
/turf/open/floor/plating/nanocarbon,
/area/shuttle/personally_bought/mining_hub)
"cu" = (
/turf/closed/wall/mineral/nanocarbon/nodiagonal/secondary_colour,
/area/shuttle/personally_bought/mining_hub)
"cv" = (
/obj/machinery/atmospherics/pipe/smart/manifold4w/supply/hidden/layer4,
/obj/machinery/atmospherics/pipe/smart/manifold4w/scrubbers/hidden/layer2,
/obj/structure/cable,
/turf/open/floor/plating/nanocarbon,
/area/shuttle/personally_bought/mining_hub)
"cL" = (
/obj/machinery/atmospherics/components/unary/vent_pump/on/layer4{
	dir = 4
	},
/obj/effect/spawner/random/salvage/crate_only/civilian_supply,
/turf/open/floor/plating/nanocarbon,
/area/shuttle/personally_bought/mining_hub)
"dW" = (
/obj/structure/closet/crate/cardboard/tiziran,
/obj/item/reagent_containers/cup/coffeepot,
/obj/item/coffee_cartridge/fancy,
/obj/item/coffee_cartridge/fancy,
/obj/item/coffee_cartridge,
/obj/item/coffee_cartridge,
/obj/item/coffee_cartridge,
/obj/item/coffee_cartridge,
/obj/item/coffee_cartridge,
/obj/item/coffee_cartridge,
/obj/item/coffee_cartridge/decaf,
/obj/item/coffee_cartridge/decaf,
/obj/item/reagent_containers/cup/glass/coffee_cup,
/obj/item/reagent_containers/cup/glass/coffee_cup,
/obj/item/reagent_containers/cup/glass/coffee_cup,
/turf/open/floor/plating/nanocarbon,
/area/shuttle/personally_bought/mining_hub)
"ed" = (
/obj/machinery/atmospherics/components/unary/vent_scrubber/on/layer2{
	dir = 8
	},
/turf/open/floor/plating/nanocarbon,
/area/shuttle/personally_bought/mining_hub)
"eo" = (
/obj/structure/shuttle_decoration/eva_catwalks/directional/south,
/obj/structure/shuttle_decoration/wall_plate/gold_foil{
	dir = 1
	},
/turf/closed/wall/mineral/nanocarbon/nodiagonal/primary_colour,
/area/shuttle/personally_bought/mining_hub)
"es" = (
/obj/machinery/holopad,
/obj/machinery/button/door/personal_shuttle_windows/directional/north,
/turf/open/floor/plating/nanocarbon,
/area/shuttle/personally_bought/mining_hub)
"ew" = (
/obj/machinery/atmospherics/pipe/smart/manifold4w/scrubbers/hidden/layer2,
/obj/machinery/atmospherics/pipe/smart/manifold4w/supply/hidden/layer4,
/turf/open/floor/iron/colony/texture/nanocarbon,
/area/shuttle/personally_bought/mining_hub)
"eL" = (
/obj/structure/shuttle_decoration/wall_plate/armor{
	dir = 8
	},
/turf/closed/wall/mineral/aluminum,
/area/shuttle/personally_bought/mining_hub)
"fm" = (
/obj/structure/shuttle_decoration/wall_plate/gold_foil{
	dir = 8
	},
/obj/structure/shuttle_decoration/wall_plate/armor{
	dir = 4
	},
/turf/closed/wall/mineral/aluminum,
/area/shuttle/personally_bought/mining_hub)
"gK" = (
/turf/closed/wall/mineral/nanocarbon/secondary_colour,
/area/shuttle/personally_bought/mining_hub)
"hh" = (
/obj/structure/chair/comfy/shuttle{
	dir = 1
	},
/turf/open/floor/plating/nanocarbon,
/area/shuttle/personally_bought/mining_hub)
"hk" = (
/obj/structure/cable,
/obj/machinery/atmospherics/pipe/smart/manifold4w/scrubbers/hidden/layer2,
/obj/structure/mineral_door/manual_colony_door/shuttle/interior,
/turf/open/floor/plating/nanocarbon,
/area/shuttle/personally_bought/mining_hub)
"il" = (
/obj/machinery/power/shuttle_engine/propulsion{
	dir = 8
	},
/obj/structure/engine_covers/thruster_nozzle{
	dir = 8
	},
/turf/open/floor/plating/nanocarbon/airless,
/area/shuttle/personally_bought/mining_hub)
"in" = (
/obj/structure/cable,
/obj/machinery/atmospherics/pipe/smart/manifold4w/supply/hidden/layer4,
/obj/machinery/atmospherics/pipe/smart/manifold4w/scrubbers/hidden/layer2,
/turf/open/floor/catwalk_floor/colony_fabricator/nanocarbon,
/area/shuttle/personally_bought/mining_hub)
"iN" = (
/obj/structure/shuttle_decoration/console/directional/west,
/turf/closed/wall/mineral/aluminum,
/area/shuttle/personally_bought/mining_hub)
"jB" = (
/turf/open/floor/iron/colony/nanocarbon,
/area/shuttle/personally_bought/mining_hub)
"jT" = (
/obj/structure/shuttle_decoration/bullbar/directional/east,
/obj/structure/shuttle_decoration/headlight/directional/east,
/turf/closed/wall/mineral/nanocarbon/nodiagonal/primary_colour,
/area/shuttle/personally_bought/mining_hub)
"ka" = (
/obj/structure/shuttle_decoration/extinguisher/directional/south,
/turf/closed/wall/mineral/aluminum,
/area/shuttle/personally_bought/mining_hub)
"ky" = (
/obj/machinery/atmos_shield_gen/active{
	dir = 8
	},
/obj/machinery/door/poddoor/preopen/personal_bay_one,
/obj/machinery/button/door/personal_shuttle_bay_one/directional/east,
/turf/open/floor/plating/nanocarbon,
/area/shuttle/personally_bought/mining_hub)
"kA" = (
/obj/machinery/atmospherics/components/unary/vent_pump/on/layer4{
	dir = 4
	},
/obj/machinery/light/red/directional/north,
/obj/machinery/button/door/personal_shuttle_bay_two/directional/west,
/turf/open/floor/plating/nanocarbon,
/area/shuttle/personally_bought/mining_hub)
"kO" = (
/obj/machinery/exoscanner/shuttle_part/radio_dish/directional/east,
/turf/closed/wall/mineral/nanocarbon/nodiagonal/secondary_colour,
/area/shuttle/personally_bought/mining_hub)
"lk" = (
/obj/machinery/door/poddoor/preopen/personal_shuttle_windows,
/obj/structure/window/fulltile/salvage_shuttle,
/turf/open/floor/plating/nanocarbon,
/area/shuttle/personally_bought/mining_hub)
"lR" = (
/obj/structure/tank_dispenser,
/turf/open/floor/plating/nanocarbon,
/area/shuttle/personally_bought/mining_hub)
"mb" = (
/obj/structure/shuttle_decoration/radiator/directional/south,
/turf/closed/wall/mineral/nanocarbon/nodiagonal/black,
/area/shuttle/personally_bought/mining_hub)
"mh" = (
/obj/item/radio/intercom/directional/south,
/obj/structure/chair/comfy/shuttle{
	dir = 1
	},
/turf/open/floor/iron/colony/nanocarbon,
/area/shuttle/personally_bought/mining_hub)
"mY" = (
/obj/structure/shuttle_decoration/extinguisher/directional/north,
/turf/closed/wall/mineral/aluminum,
/area/shuttle/personally_bought/mining_hub)
"na" = (
/obj/structure/shuttle_decoration/wall_plate/gold_foil,
/turf/closed/wall/mineral/aluminum,
/area/shuttle/personally_bought/mining_hub)
"nd" = (
/obj/effect/mapping_helpers/airlock/cyclelink_helper{
	dir = 1
	},
/obj/structure/fans/tiny,
/obj/machinery/door/airlock/spacer,
/turf/open/floor/plating/nanocarbon,
/area/shuttle/personally_bought/mining_hub)
"nD" = (
/obj/machinery/atmospherics/pipe/smart/manifold4w/scrubbers/hidden/layer2,
/obj/machinery/atmospherics/pipe/smart/manifold4w/supply/hidden/layer4,
/obj/structure/mineral_door/manual_colony_door/shuttle/interior,
/turf/open/floor/plating/nanocarbon,
/area/shuttle/personally_bought/mining_hub)
"nJ" = (
/obj/structure/shuttle_decoration/wall_plate/armor{
	dir = 8
	},
/obj/structure/shuttle_decoration/wall_plate/plastamic{
	dir = 4
	},
/turf/closed/wall/mineral/aluminum,
/area/shuttle/personally_bought/mining_hub)
"og" = (
/obj/machinery/atmospherics/components/unary/vent_pump/on/layer4{
	dir = 4
	},
/turf/open/floor/iron/colony/texture/nanocarbon,
/area/shuttle/personally_bought/mining_hub)
"oT" = (
/obj/structure/shuttle_decoration/junction_box/directional/east,
/turf/closed/wall/mineral/aluminum,
/area/shuttle/personally_bought/mining_hub)
"pd" = (
/obj/structure/cable,
/obj/machinery/atmospherics/pipe/smart/manifold4w/supply/hidden/layer4,
/obj/machinery/atmospherics/pipe/smart/manifold4w/scrubbers/hidden/layer2,
/obj/structure/mineral_door/manual_colony_door/shuttle/interior,
/turf/open/floor/plating/nanocarbon,
/area/shuttle/personally_bought/mining_hub)
"pe" = (
/turf/open/floor/iron/colony/texture/nanocarbon,
/area/shuttle/personally_bought/mining_hub)
"pq" = (
/obj/machinery/atmospherics/components/unary/vent_scrubber/on/layer2{
	dir = 8
	},
/obj/machinery/atmospherics/pipe/smart/manifold4w/supply/hidden/layer4,
/obj/structure/sink/cycler/directional/north,
/turf/open/floor/iron/colony/white/nanocarbon,
/area/shuttle/personally_bought/mining_hub)
"py" = (
/obj/structure/shuttle_decoration/ladder_black/directional/south,
/turf/closed/wall/mineral/nanocarbon/nodiagonal/secondary_colour,
/area/shuttle/personally_bought/mining_hub)
"pH" = (
/obj/structure/cable,
/obj/machinery/atmospherics/pipe/smart/manifold4w/supply/hidden/layer4,
/obj/machinery/atmospherics/pipe/smart/manifold4w/scrubbers/hidden/layer2,
/turf/open/floor/iron/colony/nanocarbon,
/area/shuttle/personally_bought/mining_hub)
"ql" = (
/obj/machinery/portable_atmospherics/canister/air,
/obj/machinery/atmospherics/components/unary/portables_connector/visible/layer4{
	dir = 4
	},
/turf/open/floor/plating/nanocarbon,
/area/shuttle/personally_bought/mining_hub)
"qp" = (
/obj/machinery/atmospherics/pipe/smart/manifold4w/scrubbers/hidden/layer2,
/obj/machinery/atmospherics/pipe/smart/manifold4w/supply/hidden/layer4,
/obj/structure/mineral_door/manual_colony_door/shuttle,
/turf/open/floor/plating/nanocarbon,
/area/shuttle/personally_bought/mining_hub)
"qE" = (
/obj/machinery/atmospherics/components/unary/vent_scrubber/on/layer2{
	dir = 4
	},
/obj/machinery/computer/monitor,
/obj/structure/cable,
/turf/open/floor/plating/nanocarbon,
/area/shuttle/personally_bought/mining_hub)
"rf" = (
/obj/structure/table/reinforced,
/obj/machinery/recharger,
/obj/machinery/light/warm/directional/south,
/turf/open/floor/iron/dark/smooth_large,
/area/shuttle/personally_bought/mining_hub)
"sI" = (
/obj/structure/closet/sleeping_compartment,
/turf/open/floor/plating/nanocarbon,
/area/shuttle/personally_bought/mining_hub)
"tC" = (
/obj/machinery/atmospherics/pipe/smart/manifold4w/supply/hidden/layer4,
/obj/machinery/atmospherics/pipe/smart/manifold4w/scrubbers/hidden/layer2,
/obj/structure/cable,
/turf/open/floor/catwalk_floor/colony_fabricator/nanocarbon,
/area/shuttle/personally_bought/mining_hub)
"tO" = (
/obj/machinery/atmospherics/components/unary/vent_scrubber/on/layer2{
	dir = 8
	},
/turf/open/floor/iron/colony/nanocarbon,
/area/shuttle/personally_bought/mining_hub)
"tU" = (
/obj/structure/shuttle_decoration/radiator/directional/north,
/turf/closed/wall/mineral/nanocarbon/nodiagonal/black,
/area/shuttle/personally_bought/mining_hub)
"uf" = (
/obj/effect/mapping_helpers/airlock/cyclelink_helper{
	dir = 1
	},
/obj/machinery/atmospherics/pipe/smart/manifold4w/supply/hidden/layer4,
/obj/machinery/door/airlock/spacer,
/turf/open/floor/plating/nanocarbon,
/area/shuttle/personally_bought/mining_hub)
"ug" = (
/obj/machinery/door/poddoor/preopen/personal_bay_one,
/turf/open/floor/plating/nanocarbon,
/area/shuttle/personally_bought/mining_hub)
"uw" = (
/obj/structure/shuttle_decoration/eva_catwalks/directional/east,
/turf/closed/wall/mineral/nanocarbon/nodiagonal/primary_colour,
/area/shuttle/personally_bought/mining_hub)
"uT" = (
/obj/machinery/modular_computer/preset/engineering{
	dir = 1
	},
/obj/structure/cable,
/obj/machinery/digital_clock/directional/south,
/turf/open/floor/plating/nanocarbon,
/area/shuttle/personally_bought/mining_hub)
"uU" = (
/obj/machinery/atmospherics/pipe/smart/manifold4w/supply/hidden/layer4,
/obj/machinery/atmospherics/pipe/smart/manifold4w/scrubbers/hidden/layer2,
/turf/open/floor/catwalk_floor/colony_fabricator/nanocarbon,
/area/shuttle/personally_bought/mining_hub)
"vK" = (
/obj/effect/spawner/random/engineering/canister,
/turf/open/floor/plating/aluminum,
/area/shuttle/personally_bought/mining_hub)
"wb" = (
/obj/structure/shuttle_decoration/wall_plate/armor{
	dir = 1
	},
/turf/closed/wall/mineral/nanocarbon/nodiagonal/black,
/area/shuttle/personally_bought/mining_hub)
"wt" = (
/obj/structure/mineral_door/manual_colony_door/shuttle/interior,
/obj/machinery/atmospherics/pipe/smart/manifold4w/supply/hidden/layer4,
/obj/machinery/atmospherics/pipe/smart/manifold4w/scrubbers/hidden/layer2,
/obj/structure/cable,
/turf/open/floor/plating/nanocarbon,
/area/shuttle/personally_bought/mining_hub)
"wI" = (
/obj/machinery/atmospherics/pipe/smart/manifold4w/supply/hidden/layer4,
/obj/machinery/atmospherics/pipe/smart/manifold4w/scrubbers/hidden/layer2,
/obj/effect/mapping_helpers/airlock/cyclelink_helper,
/obj/machinery/door/airlock/spacer,
/turf/open/floor/plating/nanocarbon,
/area/shuttle/personally_bought/mining_hub)
"wU" = (
/obj/machinery/recharge_station,
/obj/machinery/atmospherics/components/unary/vent_scrubber/on/layer2,
/turf/open/floor/plating/nanocarbon,
/area/shuttle/personally_bought/mining_hub)
"xN" = (
/obj/machinery/atmospherics/pipe/smart/manifold4w/supply/hidden/layer4,
/obj/machinery/atmospherics/pipe/smart/manifold4w/scrubbers/hidden/layer2,
/obj/structure/mineral_door/manual_colony_door/shuttle/interior,
/turf/open/floor/plating/nanocarbon,
/area/shuttle/personally_bought/mining_hub)
"xW" = (
/turf/template_noop,
/area/template_noop)
"yN" = (
/obj/effect/spawner/random/salvage/crate_only/civilian_supply,
/turf/open/floor/plating/nanocarbon,
/area/shuttle/personally_bought/mining_hub)
"zo" = (
/obj/effect/mapping_helpers/airlock/cyclelink_helper,
/obj/docking_port/mobile/personally_bought{
	dir = 2;
	port_direction = 8
	},
/obj/structure/fans/tiny,
/obj/machinery/door/airlock/spacer,
/turf/open/floor/plating/nanocarbon,
/area/shuttle/personally_bought/mining_hub)
"zH" = (
/turf/closed/wall/mineral/nanocarbon/nodiagonal/black,
/area/shuttle/personally_bought/mining_hub)
"zJ" = (
/obj/structure/extinguisher_cabinet/directional/north,
/obj/structure/table/reinforced,
/obj/machinery/coffeemaker,
/turf/open/floor/plating/nanocarbon,
/area/shuttle/personally_bought/mining_hub)
"Ar" = (
/obj/machinery/atmos_shield_gen/active{
	dir = 4
	},
/obj/machinery/door/poddoor/preopen/personal_bay_one,
/obj/machinery/button/door/personal_shuttle_bay_one/directional/west,
/turf/open/floor/plating/nanocarbon,
/area/shuttle/personally_bought/mining_hub)
"Ax" = (
/obj/machinery/light/cold/directional/west,
/obj/machinery/atmospherics/pipe/smart/manifold4w/supply/hidden/layer4,
/obj/machinery/atmospherics/pipe/smart/manifold4w/scrubbers/hidden/layer2,
/turf/open/floor/iron/colony/texture/nanocarbon,
/area/shuttle/personally_bought/mining_hub)
"AD" = (
/turf/closed/wall/mineral/nanocarbon/primary_colour,
/area/shuttle/personally_bought/mining_hub)
"AT" = (
/obj/machinery/atmospherics/components/unary/vent_scrubber/on/layer2{
	dir = 8
	},
/turf/open/floor/iron/colony/texture/nanocarbon,
/area/shuttle/personally_bought/mining_hub)
"Bb" = (
/obj/machinery/portable_atmospherics/canister,
/obj/machinery/atmospherics/components/unary/portables_connector/visible/layer2{
	dir = 4
	},
/turf/open/floor/plating/nanocarbon,
/area/shuttle/personally_bought/mining_hub)
"Bc" = (
/obj/machinery/atmos_shield_gen/active{
	dir = 8
	},
/obj/machinery/door/poddoor/preopen/personal_bay_two,
/obj/machinery/button/door/personal_shuttle_bay_two/directional/east,
/turf/open/floor/plating/nanocarbon,
/area/shuttle/personally_bought/mining_hub)
"Bh" = (
/obj/structure/shuttle_decoration/wall_plate/gold_foil,
/turf/closed/wall/mineral/nanocarbon/nodiagonal/black,
/area/shuttle/personally_bought/mining_hub)
"BA" = (
/obj/machinery/power/micro_reactor,
/obj/structure/cable,
/turf/open/floor/plating/nanocarbon,
/area/shuttle/personally_bought/mining_hub)
"BE" = (
/obj/structure/shuttle_decoration/wall_plate/gold_foil{
	dir = 1
	},
/turf/closed/wall/mineral/aluminum,
/area/shuttle/personally_bought/mining_hub)
"BR" = (
/obj/machinery/atmospherics/pipe/smart/manifold4w/supply/hidden/layer4,
/obj/machinery/atmospherics/pipe/smart/manifold4w/scrubbers/hidden/layer2,
/obj/structure/table/reinforced,
/obj/machinery/microwave/engineering/cell_included,
/turf/open/floor/plating/nanocarbon,
/area/shuttle/personally_bought/mining_hub)
"BZ" = (
/obj/structure/closet/firecloset/shuttle,
/turf/open/floor/plating/nanocarbon,
/area/shuttle/personally_bought/mining_hub)
"CW" = (
/obj/machinery/computer/camera_advanced/shuttle_docker/personally_bought{
	x_offset = -5;
	y_offset = -5;
	view_range = 4
	},
/turf/open/floor/plating/nanocarbon,
/area/shuttle/personally_bought/mining_hub)
"DD" = (
/obj/structure/shuttle_decoration/wall_plate/armor,
/turf/closed/wall/mineral/nanocarbon/nodiagonal/black,
/area/shuttle/personally_bought/mining_hub)
"DE" = (
/obj/structure/shuttle_decoration/extinguisher/directional/north,
/obj/structure/shuttle_decoration/eva_catwalks/directional/north,
/obj/structure/shuttle_decoration/wall_plate/gold_foil,
/turf/closed/wall/mineral/nanocarbon/nodiagonal/black,
/area/shuttle/personally_bought/mining_hub)
"DJ" = (
/obj/machinery/computer/shuttle/personally_bought,
/turf/open/floor/plating/nanocarbon,
/area/shuttle/personally_bought/mining_hub)
"Eg" = (
/obj/structure/shuttle_decoration/bullbar/directional/east,
/obj/structure/shuttle_decoration/headlight/directional/east,
/obj/structure/shuttle_decoration/eva_catwalks/directional/east,
/turf/closed/wall/mineral/nanocarbon/nodiagonal/primary_colour,
/area/shuttle/personally_bought/mining_hub)
"Er" = (
/obj/structure/cable,
/obj/machinery/atmospherics/pipe/smart/manifold4w/supply/hidden/layer4,
/obj/structure/mineral_door/manual_colony_door/shuttle/interior,
/turf/open/floor/plating/nanocarbon,
/area/shuttle/personally_bought/mining_hub)
"EO" = (
/obj/structure/shuttle_decoration/headlight/directional/south,
/turf/closed/wall/mineral/nanocarbon/nodiagonal/primary_colour,
/area/shuttle/personally_bought/mining_hub)
"Fu" = (
/obj/structure/shuttle_decoration/extinguisher/directional/south,
/obj/structure/shuttle_decoration/eva_catwalks/directional/south,
/obj/structure/shuttle_decoration/wall_plate/gold_foil{
	dir = 1
	},
/turf/closed/wall/mineral/nanocarbon/nodiagonal/black,
/area/shuttle/personally_bought/mining_hub)
"Gh" = (
/obj/structure/shuttle_decoration/wall_plate/plastamic{
	dir = 8
	},
/turf/closed/wall/mineral/aluminum,
/area/shuttle/personally_bought/mining_hub)
"Gp" = (
/obj/structure/shuttle_decoration/wall_plate/armor,
/obj/structure/shuttle_decoration/eva_catwalks/directional/south,
/turf/closed/wall/mineral/nanocarbon/nodiagonal/black,
/area/shuttle/personally_bought/mining_hub)
"Gs" = (
/obj/structure/shuttle_decoration/rcs/directional/north,
/turf/closed/wall/mineral/nanocarbon/nodiagonal/primary_colour,
/area/shuttle/personally_bought/mining_hub)
"GD" = (
/obj/machinery/airalarm/directional/east,
/obj/effect/mapping_helpers/airalarm/all_access,
/obj/structure/closet/sleeping_compartment,
/turf/open/floor/plating/nanocarbon,
/area/shuttle/personally_bought/mining_hub)
"Hk" = (
/obj/structure/shuttle_decoration/wall_plate/armor{
	dir = 1
	},
/obj/structure/shuttle_decoration/eva_catwalks/directional/north,
/turf/closed/wall/mineral/nanocarbon/nodiagonal/black,
/area/shuttle/personally_bought/mining_hub)
"Iu" = (
/obj/structure/shuttle_decoration/eva_catwalks/directional/north,
/turf/closed/wall/mineral/nanocarbon/nodiagonal/primary_colour,
/area/shuttle/personally_bought/mining_hub)
"IF" = (
/obj/machinery/atmospherics/pipe/smart/manifold4w/supply/hidden/layer4,
/obj/machinery/atmospherics/pipe/smart/manifold4w/scrubbers/hidden/layer2,
/obj/structure/cable,
/obj/structure/mineral_door/manual_colony_door/shuttle/interior,
/turf/open/floor/plating/nanocarbon,
/area/shuttle/personally_bought/mining_hub)
"JI" = (
/obj/structure/shuttle_decoration/ladder_black/directional/north,
/turf/closed/wall/mineral/nanocarbon/nodiagonal/secondary_colour,
/area/shuttle/personally_bought/mining_hub)
"JP" = (
/obj/machinery/portable_atmospherics/canister/oxygen,
/obj/machinery/atmospherics/components/unary/vent_scrubber/on/layer2{
	dir = 4
	},
/obj/machinery/light/red/dim/directional/west,
/turf/open/floor/plating/nanocarbon,
/area/shuttle/personally_bought/mining_hub)
"JU" = (
/obj/structure/chair/comfy/shuttle{
	dir = 4
	},
/turf/open/floor/plating/nanocarbon,
/area/shuttle/personally_bought/mining_hub)
"KV" = (
/obj/structure/shuttle_decoration/wall_plate/gold_foil{
	dir = 1
	},
/turf/closed/wall/mineral/nanocarbon/nodiagonal/black,
/area/shuttle/personally_bought/mining_hub)
"Lw" = (
/obj/structure/extinguisher_cabinet/directional/north,
/obj/machinery/recharge_station,
/obj/machinery/light/red/directional/north,
/obj/machinery/atmospherics/pipe/smart/manifold4w/scrubbers/hidden/layer2,
/turf/open/floor/plating/nanocarbon,
/area/shuttle/personally_bought/mining_hub)
"LX" = (
/turf/closed/wall/mineral/aluminum,
/area/shuttle/personally_bought/mining_hub)
"Ma" = (
/turf/open/floor/plating/aluminum,
/area/shuttle/personally_bought/mining_hub)
"Mf" = (
/obj/structure/cable,
/obj/machinery/atmospherics/pipe/smart/manifold4w/supply/hidden/layer4,
/obj/machinery/atmospherics/pipe/smart/manifold4w/scrubbers/hidden/layer2,
/obj/machinery/vending/wallmed/directional/south,
/turf/open/floor/iron/colony/texture/nanocarbon,
/area/shuttle/personally_bought/mining_hub)
"Mi" = (
/obj/structure/shuttle_decoration/wall_plate/armor,
/obj/structure/shuttle_decoration/wall_plate/armor{
	dir = 1
	},
/turf/closed/wall/mineral/aluminum,
/area/shuttle/personally_bought/mining_hub)
"Mo" = (
/obj/structure/shuttle_decoration/wall_plate/gold_foil{
	dir = 8
	},
/turf/closed/wall/mineral/aluminum,
/area/shuttle/personally_bought/mining_hub)
"MV" = (
/obj/machinery/atmos_shield_gen/active{
	dir = 4
	},
/obj/machinery/door/poddoor/preopen/personal_bay_two,
/obj/machinery/button/door/personal_shuttle_bay_two/directional/west,
/turf/open/floor/plating/nanocarbon,
/area/shuttle/personally_bought/mining_hub)
"NN" = (
/obj/machinery/atmospherics/pipe/smart/manifold4w/supply/hidden/layer4,
/obj/machinery/atmospherics/pipe/smart/manifold4w/scrubbers/hidden/layer2,
/turf/open/floor/iron/colony/nanocarbon,
/area/shuttle/personally_bought/mining_hub)
"Oi" = (
/obj/machinery/digital_clock/directional/south,
/obj/structure/chair/comfy/shuttle{
	dir = 1
	},
/turf/open/floor/plating/nanocarbon,
/area/shuttle/personally_bought/mining_hub)
"Ov" = (
/obj/machinery/power/shuttle_engine/heater{
	dir = 8
	},
/obj/structure/engine_covers/heater_cover{
	dir = 4
	},
/turf/open/floor/plating/nanocarbon/airless,
/area/shuttle/personally_bought/mining_hub)
"OF" = (
/obj/machinery/atmospherics/components/unary/vent_pump/on/layer4{
	dir = 4
	},
/obj/machinery/light/cold/directional/west,
/obj/structure/tank_dispenser,
/turf/open/floor/plating/nanocarbon,
/area/shuttle/personally_bought/mining_hub)
"OO" = (
/obj/machinery/atmospherics/pipe/smart/manifold4w/supply/hidden/layer4,
/turf/open/floor/iron/colony/nanocarbon,
/area/shuttle/personally_bought/mining_hub)
"OZ" = (
/obj/structure/closet/firecloset/shuttle/tools,
/obj/machinery/light/blacklight/directional/east,
/turf/open/floor/plating/nanocarbon,
/area/shuttle/personally_bought/mining_hub)
"Px" = (
/obj/structure/closet/emcloset,
/turf/open/floor/plating/nanocarbon,
/area/shuttle/personally_bought/mining_hub)
"PD" = (
/obj/structure/cable,
/obj/machinery/atmospherics/pipe/smart/manifold4w/supply/hidden/layer4,
/obj/machinery/atmospherics/pipe/smart/manifold4w/scrubbers/hidden/layer2,
/obj/machinery/wall_healer/free/directional/south,
/turf/open/floor/iron/colony/texture/nanocarbon,
/area/shuttle/personally_bought/mining_hub)
"PH" = (
/obj/structure/shuttle_decoration/bullbar/directional/east,
/obj/structure/shuttle_decoration/eva_catwalks/directional/east,
/turf/closed/wall/mineral/nanocarbon/nodiagonal/primary_colour,
/area/shuttle/personally_bought/mining_hub)
"PT" = (
/obj/machinery/atmospherics/components/unary/vent_pump/on/layer4{
	dir = 8
	},
/obj/machinery/light/warm/directional/east,
/obj/structure/toilet/space,
/turf/open/floor/iron/colony/white/texture/nanocarbon,
/area/shuttle/personally_bought/mining_hub)
"PZ" = (
/obj/machinery/door/poddoor/preopen/personal_bay_two,
/turf/open/floor/plating/nanocarbon,
/area/shuttle/personally_bought/mining_hub)
"QJ" = (
/obj/effect/spawner/random/engineering/atmospherics_portable,
/turf/open/floor/plating/aluminum,
/area/shuttle/personally_bought/mining_hub)
"QQ" = (
/obj/effect/spawner/random/salvage/container_or_crate_or_cargo/civilian_supply,
/turf/open/floor/plating/aluminum,
/area/shuttle/personally_bought/mining_hub)
"QY" = (
/obj/structure/shuttle_decoration/wall_plate/armor{
	dir = 4
	},
/turf/closed/wall/mineral/nanocarbon/nodiagonal/primary_colour,
/area/shuttle/personally_bought/mining_hub)
"Rf" = (
/obj/item/storage/toolbox/emergency,
/obj/item/binoculars,
/obj/item/trench_tool,
/obj/structure/secure_safe/directional/north,
/obj/structure/extinguisher_cabinet/directional/west,
/obj/structure/shelf,
/turf/open/floor/plating/nanocarbon,
/area/shuttle/personally_bought/mining_hub)
"Rg" = (
/obj/machinery/atmospherics/components/unary/vent_pump/on/layer4{
	dir = 4
	},
/obj/effect/spawner/random/engineering/canister,
/obj/machinery/airalarm/directional/south,
/obj/effect/mapping_helpers/airalarm/all_access,
/turf/open/floor/plating/nanocarbon,
/area/shuttle/personally_bought/mining_hub)
"Sc" = (
/obj/structure/shuttle_decoration/junction_box/directional/west,
/turf/closed/wall/mineral/aluminum,
/area/shuttle/personally_bought/mining_hub)
"TE" = (
/obj/machinery/atmospherics/pipe/smart/manifold4w/supply/hidden/layer4,
/obj/machinery/atmospherics/pipe/smart/manifold4w/scrubbers/hidden/layer2,
/turf/open/floor/iron/colony/texture/nanocarbon,
/area/shuttle/personally_bought/mining_hub)
"TM" = (
/obj/machinery/atmospherics/components/unary/vent_scrubber/on/layer2{
	dir = 4
	},
/obj/structure/chair/comfy/shuttle{
	dir = 4
	},
/turf/open/floor/plating/nanocarbon,
/area/shuttle/personally_bought/mining_hub)
"Ur" = (
/obj/machinery/suit_storage_unit/industrial/personal_shuttle,
/turf/open/floor/plating/nanocarbon,
/area/shuttle/personally_bought/mining_hub)
"XC" = (
/obj/machinery/atmospherics/pipe/smart/manifold4w/supply/hidden/layer4,
/obj/machinery/light/red/directional/south,
/turf/open/floor/plating/nanocarbon,
/area/shuttle/personally_bought/mining_hub)
"Yd" = (
/obj/structure/cable,
/obj/machinery/atmospherics/pipe/smart/manifold4w/supply/hidden/layer4,
/obj/machinery/atmospherics/pipe/smart/manifold4w/scrubbers/hidden/layer2,
/obj/machinery/airalarm/directional/east,
/obj/effect/mapping_helpers/airalarm/all_access,
/obj/machinery/light/cold/directional/east,
/obj/effect/landmark/ship_captain_spawner,
/turf/open/floor/catwalk_floor/colony_fabricator/nanocarbon,
/area/shuttle/personally_bought/mining_hub)
"Yu" = (
/obj/structure/extinguisher_cabinet/directional/west,
/obj/machinery/recharge_station,
/obj/effect/turf_decal/bot_white,
/turf/open/floor/plating/nanocarbon,
/area/shuttle/personally_bought/mining_hub)
"YB" = (
/obj/machinery/atmospherics/pipe/smart/manifold4w/supply/hidden/layer4,
/obj/machinery/atmospherics/pipe/smart/manifold4w/scrubbers/hidden/layer2,
/obj/structure/cable,
/turf/open/floor/iron/colony/nanocarbon,
/area/shuttle/personally_bought/mining_hub)
"YG" = (
/obj/machinery/atmospherics/pipe/smart/manifold4w/scrubbers/hidden/layer2,
/turf/open/floor/iron/colony/nanocarbon,
/area/shuttle/personally_bought/mining_hub)
"YW" = (
/obj/structure/cable,
/obj/machinery/atmospherics/pipe/smart/manifold4w/supply/hidden/layer4,
/obj/machinery/atmospherics/pipe/smart/manifold4w/scrubbers/hidden/layer2,
/turf/open/floor/iron/colony/texture/nanocarbon,
/area/shuttle/personally_bought/mining_hub)
"Zk" = (
/obj/structure/cable,
/obj/machinery/atmospherics/pipe/smart/manifold4w/scrubbers/hidden/layer2,
/obj/machinery/atmospherics/components/unary/vent_pump/on/layer4{
	dir = 8
	},
/turf/open/floor/iron/colony/nanocarbon,
/area/shuttle/personally_bought/mining_hub)
"Zl" = (
/obj/structure/shuttle_decoration/headlight/directional/north,
/turf/closed/wall/mineral/nanocarbon/nodiagonal/primary_colour,
/area/shuttle/personally_bought/mining_hub)
"ZH" = (
/turf/closed/wall/mineral/nanocarbon/nodiagonal/primary_colour,
/area/shuttle/personally_bought/mining_hub)

(1,1,1) = {"
xW
Mi
xW
tU
il
il
il
mb
xW
Mi
xW
"}
(2,1,1) = {"
xW
wb
il
zH
Ov
Ov
Ov
zH
il
DD
xW
"}
(3,1,1) = {"
xW
Hk
Ov
Bh
bp
BA
lR
KV
Ov
Gp
xW
"}
(4,1,1) = {"
xW
DE
Bb
na
qE
BA
Rg
LX
ql
Fu
xW
"}
(5,1,1) = {"
xW
Iu
Lw
hk
YG
in
OO
Er
XC
eo
xW
"}
(6,1,1) = {"
Gs
QY
fm
na
BZ
in
OZ
BE
fm
QY
ar
"}
(7,1,1) = {"
Zl
QQ
QQ
LX
Sc
IF
Mo
LX
QQ
vK
EO
"}
(8,1,1) = {"
Ar
QQ
Ma
ad
ka
cv
mY
kA
QJ
QQ
MV
"}
(9,1,1) = {"
ug
pe
jB
ew
qp
cv
qp
ew
jB
pe
PZ
"}
(10,1,1) = {"
ky
QQ
Ma
ed
bN
cv
bN
ed
QQ
QQ
Bc
"}
(11,1,1) = {"
Zl
vK
QQ
iN
LX
wt
LX
iN
QQ
QQ
EO
"}
(12,1,1) = {"
cu
nJ
eL
LX
yN
YB
Px
LX
eL
nJ
cu
"}
(13,1,1) = {"
JI
JP
LX
Yu
cL
tC
TM
JU
LX
JP
py
"}
(14,1,1) = {"
zo
uU
uf
pH
in
Yd
uU
NN
wI
uU
nd
"}
(15,1,1) = {"
JI
Gh
LX
pd
LX
LX
xN
Sc
oT
Gh
py
"}
(16,1,1) = {"
cu
Ur
OF
Mf
LX
ew
TE
Ax
og
hh
cu
"}
(17,1,1) = {"
ZH
wU
YW
PD
LX
nD
LX
BR
TE
Oi
ZH
"}
(18,1,1) = {"
ZH
LX
pd
LX
LX
pq
LX
zJ
AT
dW
lk
"}
(19,1,1) = {"
Gs
Rf
Zk
uT
LX
PT
LX
GD
sI
sI
ar
"}
(20,1,1) = {"
lk
CW
tO
rf
ZH
uw
Eg
PH
uw
ZH
ZH
"}
(21,1,1) = {"
lk
DJ
mh
ZH
AD
xW
xW
xW
xW
cu
cu
"}
(22,1,1) = {"
AD
ZH
es
lk
xW
xW
xW
xW
xW
kO
gK
"}
(23,1,1) = {"
xW
AD
lk
jT
xW
xW
xW
xW
xW
xW
xW
"}
