//MAP CONVERTED BY dmm2tgm.py THIS HEADER COMMENT PREVENTS RECONVERSION, DO NOT REMOVE
"a" = (
/obj/structure/marker_beacon/burgundy,
/turf/closed/wall/mineral/titanium/nodiagonal,
/area/shuttle/personally_bought/endurance_salvage)
"b" = (
/obj/structure/railing/eva_handhold/directional/south,
/turf/closed/wall/mineral/plastitanium/nodiagonal,
/area/shuttle/personally_bought/endurance_salvage)
"c" = (
/obj/structure/railing/eva_handhold/directional/south,
/turf/closed/wall/mineral/titanium/nodiagonal,
/area/shuttle/personally_bought/endurance_salvage)
"d" = (
/obj/item/tether_anchor,
/turf/closed/wall/mineral/plastitanium/nodiagonal,
/area/shuttle/personally_bought/endurance_salvage)
"f" = (
/obj/item/tether_anchor{
	anchored = 1
	},
/turf/closed/wall/mineral/plastitanium/nodiagonal,
/area/shuttle/personally_bought/endurance_salvage)
"g" = (
/turf/closed/wall/mineral/plastitanium/nodiagonal,
/area/shuttle/personally_bought/endurance_salvage)
"h" = (
/obj/structure/window/reinforced/plasma/spawner/directional/south,
/obj/effect/turf_decal/bot_white,
/obj/machinery/portable_atmospherics/canister/oxygen,
/obj/machinery/light/red/dim/directional/west,
/obj/machinery/atmospherics/components/unary/portables_connector/visible/layer4{
	dir = 1
	},
/turf/open/floor/iron/dark/smooth_large,
/area/shuttle/personally_bought/endurance_salvage)
"i" = (
/obj/structure/marker_beacon/burgundy,
/obj/structure/railing/eva_handhold/directional/north,
/turf/closed/wall/mineral/titanium/nodiagonal,
/area/shuttle/personally_bought/endurance_salvage)
"k" = (
/turf/closed/wall/mineral/titanium/nodiagonal,
/area/shuttle/personally_bought/endurance_salvage)
"l" = (
/obj/structure/marker_beacon/bronze,
/turf/closed/wall/mineral/titanium,
/area/shuttle/personally_bought/endurance_salvage)
"m" = (
/obj/structure/marker_beacon/olive,
/obj/structure/railing/eva_handhold/directional/south,
/turf/closed/wall/mineral/titanium/nodiagonal,
/area/shuttle/personally_bought/endurance_salvage)
"n" = (
/obj/machinery/computer/camera_advanced/shuttle_docker/personally_bought{
	dir = 8
	},
/obj/effect/turf_decal/bot_white,
/obj/structure/cable,
/turf/open/floor/iron/dark/smooth_large,
/area/shuttle/personally_bought/endurance_salvage)
"o" = (
/obj/structure/railing/eva_handhold/directional/north,
/turf/closed/wall/mineral/titanium/nodiagonal,
/area/shuttle/personally_bought/endurance_salvage)
"p" = (
/obj/machinery/holopad,
/obj/effect/turf_decal/bot_red,
/obj/structure/cable,
/turf/open/floor/iron/dark/smooth_large,
/area/shuttle/personally_bought/endurance_salvage)
"r" = (
/obj/structure/railing/eva_handhold/directional/north,
/turf/closed/wall/mineral/plastitanium/nodiagonal,
/area/shuttle/personally_bought/endurance_salvage)
"t" = (
/obj/machinery/recharge_station,
/obj/structure/window/reinforced/plasma/spawner/directional/north,
/obj/effect/turf_decal/bot_white,
/obj/machinery/light/red/dim/directional/west,
/obj/machinery/atmospherics/pipe/smart/manifold4w/scrubbers/hidden/layer2,
/turf/open/floor/iron/dark/smooth_large,
/area/shuttle/personally_bought/endurance_salvage)
"u" = (
/obj/structure/cable,
/turf/open/floor/iron/smooth,
/area/shuttle/personally_bought/endurance_salvage)
"v" = (
/obj/effect/turf_decal/delivery/white,
/obj/machinery/door/airlock/external,
/obj/effect/mapping_helpers/airlock/cyclelink_helper{
	dir = 8
	},
/obj/machinery/atmospherics/pipe/smart/manifold4w/scrubbers/hidden/layer2,
/obj/machinery/atmospherics/pipe/smart/manifold4w/supply/hidden/layer4,
/turf/open/floor/iron/dark/smooth_large,
/area/shuttle/personally_bought/endurance_salvage)
"w" = (
/obj/structure/table/reinforced,
/obj/machinery/coffeemaker,
/obj/machinery/vending/wallmed/directional/south,
/obj/machinery/light/cold/directional/south,
/turf/open/floor/iron/dark/smooth_large,
/area/shuttle/personally_bought/endurance_salvage)
"z" = (
/obj/effect/spawner/structure/window/reinforced/shuttle,
/obj/structure/cable,
/obj/machinery/door/poddoor/preopen/personal_shuttle_windows,
/turf/open/floor/plating,
/area/shuttle/personally_bought/endurance_salvage)
"A" = (
/obj/machinery/power/shuttle_engine/propulsion{
	dir = 8
	},
/obj/effect/turf_decal/stripes/line{
	dir = 8
	},
/turf/open/floor/plating/airless,
/area/shuttle/personally_bought/endurance_salvage)
"B" = (
/obj/structure/closet/firecloset/shuttle/tools,
/obj/effect/turf_decal/bot_white,
/obj/machinery/airalarm/directional/north,
/obj/effect/mapping_helpers/airalarm/all_access,
/turf/open/floor/iron/dark/smooth_large,
/area/shuttle/personally_bought/endurance_salvage)
"C" = (
/obj/effect/turf_decal/bot_white,
/obj/machinery/button/door/personal_shuttle_windows/directional/south,
/obj/machinery/computer/shuttle/personally_bought{
	dir = 8
	},
/turf/open/floor/iron/dark/smooth_large,
/area/shuttle/personally_bought/endurance_salvage)
"D" = (
/turf/open/floor/iron/smooth,
/area/shuttle/personally_bought/endurance_salvage)
"E" = (
/obj/machinery/power/shuttle_engine/heater{
	dir = 8
	},
/obj/effect/turf_decal/stripes/line{
	dir = 4
	},
/obj/structure/window/reinforced/plasma/spawner/directional/east,
/turf/open/floor/plating/airless,
/area/shuttle/personally_bought/endurance_salvage)
"F" = (
/turf/closed/wall/mineral/titanium,
/area/shuttle/personally_bought/endurance_salvage)
"G" = (
/obj/effect/turf_decal/delivery/white,
/obj/structure/fans/tiny,
/obj/machinery/door/airlock/external,
/obj/effect/mapping_helpers/airlock/cyclelink_helper{
	dir = 4
	},
/obj/docking_port/mobile/personally_bought,
/turf/open/floor/iron/dark/smooth_large,
/area/shuttle/personally_bought/endurance_salvage)
"H" = (
/obj/structure/table/reinforced,
/obj/machinery/microwave/engineering/cell_included,
/turf/open/floor/iron/dark/smooth_large,
/area/shuttle/personally_bought/endurance_salvage)
"J" = (
/obj/structure/cable,
/obj/structure/sink/kitchen/directional/west,
/obj/machinery/wall_healer/free/directional/east,
/turf/open/floor/catwalk_floor/iron_smooth,
/area/shuttle/personally_bought/endurance_salvage)
"K" = (
/obj/structure/marker_beacon/olive,
/turf/closed/wall/mineral/plastitanium/nodiagonal,
/area/shuttle/personally_bought/endurance_salvage)
"L" = (
/obj/machinery/atmospherics/pipe/smart/manifold4w/scrubbers/hidden/layer2,
/obj/machinery/atmospherics/pipe/smart/manifold4w/supply/hidden/layer4,
/turf/open/floor/catwalk_floor/iron_dark,
/area/shuttle/personally_bought/endurance_salvage)
"N" = (
/obj/machinery/power/micro_reactor,
/obj/machinery/atmospherics/pipe/smart/manifold4w/supply/hidden/layer4,
/obj/machinery/atmospherics/pipe/smart/manifold4w/scrubbers/hidden/layer2,
/obj/structure/cable,
/turf/open/floor/iron/dark/smooth_large,
/area/shuttle/personally_bought/endurance_salvage)
"P" = (
/obj/structure/bed/pod,
/obj/structure/curtain/bounty,
/obj/effect/turf_decal/bot_white,
/turf/open/floor/iron/dark/smooth_large,
/area/shuttle/personally_bought/endurance_salvage)
"Q" = (
/obj/machinery/atmospherics/components/unary/vent_pump/on/layer4,
/obj/effect/turf_decal/bot_white,
/obj/structure/closet/crate/cardboard/tiziran,
/obj/item/reagent_containers/cup/coffeepot,
/obj/item/coffee_cartridge/bootleg,
/obj/item/coffee_cartridge/bootleg,
/obj/item/coffee_cartridge/bootleg,
/obj/item/coffee_cartridge/bootleg,
/obj/item/reagent_containers/cup/glass/coffee_cup,
/obj/item/reagent_containers/cup/glass/coffee_cup,
/obj/item/storage/box/mothic_rations,
/obj/item/storage/box/mothic_rations,
/obj/structure/extinguisher_cabinet/directional/west,
/obj/machinery/light/cold/directional/west,
/turf/open/floor/iron/dark/smooth_large,
/area/shuttle/personally_bought/endurance_salvage)
"R" = (
/obj/structure/marker_beacon/burgundy,
/turf/closed/wall/mineral/plastitanium/nodiagonal,
/area/shuttle/personally_bought/endurance_salvage)
"S" = (
/obj/structure/marker_beacon/olive,
/turf/closed/wall/mineral/titanium/nodiagonal,
/area/shuttle/personally_bought/endurance_salvage)
"T" = (
/obj/structure/chair/comfy/shuttle{
	dir = 4
	},
/obj/effect/landmark/ship_captain_spawner,
/obj/structure/cable,
/turf/open/floor/catwalk_floor/iron_smooth,
/area/shuttle/personally_bought/endurance_salvage)
"U" = (
/turf/template_noop,
/area/template_noop)
"X" = (
/obj/structure/curtain,
/obj/machinery/shower/directional/north,
/obj/effect/turf_decal/bot_red,
/obj/structure/fluff/shower_drain,
/turf/open/floor/iron/dark/smooth_large,
/area/shuttle/personally_bought/endurance_salvage)
"Y" = (
/obj/structure/closet/firecloset/shuttle,
/obj/effect/turf_decal/bot_white,
/obj/machinery/power/apc/auto_name/directional/north,
/obj/effect/mapping_helpers/apc/unlocked,
/obj/structure/cable,
/turf/open/floor/iron/dark/smooth_large,
/area/shuttle/personally_bought/endurance_salvage)
"Z" = (
/obj/machinery/atmospherics/components/unary/vent_scrubber/on/layer2{
	dir = 1
	},
/obj/structure/toilet{
	dir = 4
	},
/obj/structure/curtain,
/obj/effect/turf_decal/bot_red,
/turf/open/floor/iron/freezer,
/area/shuttle/personally_bought/endurance_salvage)

(1,1,1) = {"
R
U
f
G
f
U
K
"}
(2,1,1) = {"
r
A
t
L
h
A
b
"}
(3,1,1) = {"
d
E
g
v
g
E
d
"}
(4,1,1) = {"
i
B
Q
N
Z
X
m
"}
(5,1,1) = {"
o
Y
u
J
D
w
c
"}
(6,1,1) = {"
z
T
p
k
P
H
k
"}
(7,1,1) = {"
z
n
C
k
k
k
k
"}
(8,1,1) = {"
a
z
k
F
U
l
S
"}
