//MAP CONVERTED BY dmm2tgm.py THIS HEADER COMMENT PREVENTS RECONVERSION, DO NOT REMOVE
"a" = (
/obj/machinery/recharge_station,
/obj/structure/window/reinforced/plasma/spawner/directional/north,
/obj/effect/turf_decal/bot_white,
/obj/machinery/light/red/dim/directional/west,
/obj/machinery/atmospherics/pipe/smart/manifold4w/scrubbers/hidden/layer2,
/turf/open/floor/iron/dark/smooth_large,
/area/shuttle/personally_bought/cramped_salvage)
"c" = (
/obj/machinery/computer/shuttle/personally_bought{
	dir = 8
	},
/obj/effect/turf_decal/bot_white,
/obj/structure/cable,
/turf/open/floor/iron/dark/smooth_large,
/area/shuttle/personally_bought/cramped_salvage)
"g" = (
/obj/machinery/power/shuttle_engine/propulsion{
	dir = 8
	},
/obj/effect/turf_decal/stripes/line{
	dir = 9
	},
/turf/open/floor/plating/airless,
/area/shuttle/personally_bought/cramped_salvage)
"h" = (
/obj/machinery/computer/camera_advanced/shuttle_docker/personally_bought{
	dir = 8
	},
/obj/effect/turf_decal/bot_white,
/obj/machinery/button/door/personal_shuttle_windows/directional/north,
/obj/item/radio/intercom/directional/east,
/obj/machinery/light/cold/directional/east,
/obj/structure/cable,
/turf/open/floor/iron/dark/smooth_large,
/area/shuttle/personally_bought/cramped_salvage)
"j" = (
/obj/machinery/holopad,
/obj/effect/turf_decal/bot_red,
/turf/open/floor/iron/dark/smooth_large,
/area/shuttle/personally_bought/cramped_salvage)
"k" = (
/turf/closed/wall/mineral/titanium/nodiagonal,
/area/shuttle/personally_bought/cramped_salvage)
"m" = (
/obj/machinery/atmospherics/pipe/smart/manifold4w/scrubbers/hidden/layer2,
/obj/machinery/atmospherics/pipe/smart/manifold4w/supply/hidden/layer4,
/turf/open/floor/catwalk_floor/iron_dark,
/area/shuttle/personally_bought/cramped_salvage)
"o" = (
/obj/effect/spawner/structure/window/reinforced/shuttle,
/obj/structure/cable,
/obj/machinery/door/poddoor/preopen/personal_shuttle_windows,
/obj/structure/railing/eva_handhold/directional/south,
/turf/open/floor/plating,
/area/shuttle/personally_bought/cramped_salvage)
"r" = (
/obj/structure/closet/firecloset/shuttle,
/obj/effect/turf_decal/bot_white,
/obj/machinery/airalarm/directional/north,
/obj/effect/mapping_helpers/airalarm/all_access,
/turf/open/floor/iron/dark/smooth_large,
/area/shuttle/personally_bought/cramped_salvage)
"s" = (
/obj/machinery/power/shuttle_engine/propulsion{
	dir = 8
	},
/obj/effect/turf_decal/stripes/line{
	dir = 10
	},
/turf/open/floor/plating/airless,
/area/shuttle/personally_bought/cramped_salvage)
"t" = (
/obj/structure/window/reinforced/plasma/spawner/directional/south,
/obj/effect/turf_decal/bot_white,
/obj/machinery/portable_atmospherics/canister/oxygen,
/obj/machinery/light/red/dim/directional/west,
/obj/machinery/atmospherics/components/unary/portables_connector/visible/layer4{
	dir = 1
	},
/turf/open/floor/iron/dark/smooth_large,
/area/shuttle/personally_bought/cramped_salvage)
"u" = (
/obj/structure/marker_beacon/burgundy,
/obj/structure/railing/eva_handhold/directional/north,
/turf/closed/wall/mineral/titanium/nodiagonal,
/area/shuttle/personally_bought/cramped_salvage)
"v" = (
/obj/effect/turf_decal/delivery/white,
/obj/structure/fans/tiny,
/obj/machinery/door/airlock/external,
/obj/effect/mapping_helpers/airlock/cyclelink_helper{
	dir = 4
	},
/obj/docking_port/mobile/personally_bought,
/turf/open/floor/iron/dark/smooth_large,
/area/shuttle/personally_bought/cramped_salvage)
"C" = (
/obj/structure/closet/crate/robust,
/obj/effect/turf_decal/bot_white,
/obj/effect/spawner/random/maintenance/no_decals/two,
/obj/machinery/wall_healer/free/directional/west,
/obj/machinery/vending/wallmed/directional/south,
/obj/machinery/atmospherics/components/unary/vent_scrubber/on/layer2{
	dir = 1
	},
/turf/open/floor/iron/dark/smooth_large,
/area/shuttle/personally_bought/cramped_salvage)
"F" = (
/obj/machinery/power/shuttle_engine/heater{
	dir = 8
	},
/obj/structure/window/reinforced/plasma/spawner/directional/east,
/obj/effect/turf_decal/stripes/line{
	dir = 5
	},
/obj/machinery/atmospherics/components/unary/passive_vent/layer2,
/obj/structure/railing/eva_handhold/directional/north,
/turf/open/floor/plating/airless,
/area/shuttle/personally_bought/cramped_salvage)
"H" = (
/obj/item/tether_anchor{
	anchored = 1
	},
/turf/closed/wall/mineral/plastitanium/nodiagonal,
/area/shuttle/personally_bought/cramped_salvage)
"I" = (
/obj/structure/marker_beacon/olive,
/obj/structure/railing/eva_handhold/directional/south,
/turf/closed/wall/mineral/titanium/nodiagonal,
/area/shuttle/personally_bought/cramped_salvage)
"M" = (
/obj/structure/chair/comfy/shuttle{
	dir = 4
	},
/obj/effect/landmark/ship_captain_spawner,
/obj/structure/cable,
/turf/open/floor/catwalk_floor/iron_smooth,
/area/shuttle/personally_bought/cramped_salvage)
"P" = (
/obj/structure/marker_beacon/burgundy,
/turf/closed/wall/mineral/titanium,
/area/shuttle/personally_bought/cramped_salvage)
"Q" = (
/obj/item/tether_anchor{
	anchored = 1
	},
/turf/closed/wall/mineral/titanium/nodiagonal,
/area/shuttle/personally_bought/cramped_salvage)
"R" = (
/obj/machinery/power/shuttle_engine/heater{
	dir = 8
	},
/obj/structure/window/reinforced/plasma/spawner/directional/east,
/obj/effect/turf_decal/stripes/line{
	dir = 6
	},
/obj/structure/railing/eva_handhold/directional/south,
/turf/open/floor/plating/airless,
/area/shuttle/personally_bought/cramped_salvage)
"S" = (
/obj/structure/closet/firecloset/shuttle/tools,
/obj/effect/turf_decal/bot_white,
/obj/structure/cable,
/obj/machinery/power/apc/auto_name/directional/north,
/obj/effect/mapping_helpers/apc/unlocked,
/obj/effect/mapping_helpers/apc/cell_5k,
/obj/structure/extinguisher_cabinet/directional/west,
/obj/machinery/atmospherics/components/unary/vent_pump/on/layer4,
/turf/open/floor/iron/dark/smooth_large,
/area/shuttle/personally_bought/cramped_salvage)
"T" = (
/obj/machinery/power/micro_reactor,
/obj/structure/cable,
/obj/machinery/atmospherics/pipe/smart/manifold4w/scrubbers/hidden/layer2,
/obj/machinery/atmospherics/pipe/smart/manifold4w/supply/hidden/layer4,
/turf/open/floor/iron/dark/smooth_large,
/area/shuttle/personally_bought/cramped_salvage)
"U" = (
/turf/template_noop,
/area/template_noop)
"V" = (
/obj/effect/turf_decal/delivery/white,
/obj/machinery/door/airlock/external,
/obj/effect/mapping_helpers/airlock/cyclelink_helper{
	dir = 8
	},
/obj/machinery/atmospherics/pipe/smart/manifold4w/scrubbers/hidden/layer2,
/obj/machinery/atmospherics/pipe/smart/manifold4w/supply/hidden/layer4,
/turf/open/floor/iron/dark/smooth_large,
/area/shuttle/personally_bought/cramped_salvage)
"W" = (
/obj/effect/spawner/structure/window/reinforced/shuttle,
/obj/structure/cable,
/obj/machinery/door/poddoor/preopen/personal_shuttle_windows,
/turf/open/floor/plating,
/area/shuttle/personally_bought/cramped_salvage)
"X" = (
/obj/structure/marker_beacon/olive,
/turf/closed/wall/mineral/titanium/nodiagonal,
/area/shuttle/personally_bought/cramped_salvage)
"Y" = (
/turf/closed/wall/mineral/plastitanium/nodiagonal,
/area/shuttle/personally_bought/cramped_salvage)
"Z" = (
/obj/structure/railing/eva_handhold/directional/north,
/turf/closed/wall/mineral/titanium/nodiagonal,
/area/shuttle/personally_bought/cramped_salvage)

(1,1,1) = {"
g
H
v
H
s
"}
(2,1,1) = {"
F
a
m
t
R
"}
(3,1,1) = {"
u
Y
V
Y
I
"}
(4,1,1) = {"
k
S
T
C
k
"}
(5,1,1) = {"
Z
r
M
j
o
"}
(6,1,1) = {"
P
k
h
c
W
"}
(7,1,1) = {"
U
Q
k
W
X
"}
