//MAP CONVERTED BY dmm2tgm.py THIS HEADER COMMENT PREVENTS RECONVERSION, DO NOT REMOVE
"ao" = (
/obj/structure/cable,
/obj/machinery/atmospherics/pipe/smart/manifold4w/supply/hidden/layer4,
/obj/machinery/atmospherics/pipe/smart/manifold4w/scrubbers/hidden/layer2,
/obj/machinery/door/airlock/hatch,
/obj/effect/mapping_helpers/airlock/cutaiwire,
/turf/open/floor/iron/dark,
/area/shuttle/pirate/tiziran_corvette)
"bn" = (
/obj/structure/railing/eva_handhold/directional/west,
/turf/closed/wall/mineral/plastitanium/nodiagonal,
/area/shuttle/pirate/tiziran_corvette)
"bB" = (
/obj/structure/cable,
/obj/machinery/light/red/directional/west,
/obj/effect/mapping_helpers/airlock/cyclelink_helper,
/obj/effect/mapping_helpers/airlock/cutaiwire,
/obj/machinery/door/airlock/external{
	id_tag = "pirateforeexternal";
	req_access = list("syndicate")
	},
/turf/open/floor/catwalk_floor/iron_dark/airless,
/area/shuttle/pirate/tiziran_corvette)
"ce" = (
/obj/effect/mapping_helpers/airlock/cutaiwire,
/obj/machinery/atmospherics/pipe/smart/manifold4w/supply/hidden/layer4,
/obj/machinery/atmospherics/pipe/smart/manifold4w/scrubbers/hidden/layer2,
/obj/machinery/door/airlock/hatch{
	req_access = list("syndicate")
	},
/turf/open/floor/catwalk_floor/iron_dark,
/area/shuttle/pirate/tiziran_corvette)
"cv" = (
/obj/machinery/atmospherics/components/unary/vent_scrubber/on/layer2{
	dir = 1
	},
/obj/machinery/airalarm/directional/west,
/obj/effect/mapping_helpers/airalarm/all_access,
/turf/open/floor/iron/dark,
/area/shuttle/pirate/tiziran_corvette)
"cE" = (
/obj/structure/window/reinforced/survival_pod/spawner/directional/north,
/obj/machinery/door/window/survival_pod/left/directional/west{
	req_access = list("syndicate")
	},
/turf/open/floor/plating,
/area/shuttle/pirate/tiziran_corvette)
"do" = (
/obj/machinery/porta_turret/syndicate{
	dir = 1
	},
/turf/closed/wall/mineral/plastitanium,
/area/shuttle/pirate/tiziran_corvette)
"dO" = (
/obj/machinery/atmospherics/components/unary/vent_scrubber/on/layer2{
	dir = 8
	},
/obj/item/rolling_table_dock,
/obj/effect/spawner/random/vendor_meal_sides/tizira,
/obj/item/reagent_containers/condiment/pack/ketchup{
	pixel_y = 7;
	pixel_x = -9
	},
/turf/open/floor/plating,
/area/shuttle/pirate/tiziran_corvette)
"ee" = (
/obj/machinery/door/airlock/external{
	id_tag = "piratestarboardexternal";
	req_access = list("syndicate")
	},
/obj/docking_port/mobile/pirate{
	dir = 4;
	preferred_direction = 4;
	port_direction = 4
	},
/obj/effect/mapping_helpers/airlock/cutaiwire,
/obj/effect/mapping_helpers/airlock/cyclelink_helper{
	dir = 4
	},
/turf/open/floor/catwalk_floor/iron_dark,
/area/shuttle/pirate/tiziran_corvette)
"eq" = (
/obj/structure/cable,
/obj/machinery/atmospherics/pipe/smart/manifold4w/supply/hidden/layer4,
/obj/machinery/atmospherics/pipe/smart/manifold4w/scrubbers/hidden/layer2,
/obj/structure/curtain/bounty/start_closed,
/turf/open/floor/iron/dark,
/area/shuttle/pirate/tiziran_corvette)
"ex" = (
/obj/structure/table/reinforced/plastitaniumglass,
/obj/machinery/button/door{
	id = "piratebridge";
	name = "Window Shutters Control"
	},
/obj/structure/marker_beacon/burgundy,
/turf/open/floor/iron/dark/textured,
/area/shuttle/pirate/tiziran_corvette)
"eY" = (
/obj/structure/chair/bronze,
/obj/machinery/atmospherics/pipe/smart/manifold4w/scrubbers/hidden/layer2,
/obj/structure/marker_beacon/burgundy,
/turf/open/floor/iron/dark/smooth_half,
/area/shuttle/pirate/tiziran_corvette)
"fA" = (
/obj/machinery/shuttle_scrambler,
/obj/structure/cable,
/obj/machinery/turretid{
	ailock = 1;
	desc = "A specially designed set of turret controls. Looks to be covered in protective casing to prevent AI interfacing.";
	icon_state = "control_kill";
	lethal = 1;
	name = "Ship Turret Control";
	pixel_x = 30;
	pixel_y = 4;
	req_access = list("syndicate")
	},
/obj/structure/marker_beacon/burgundy,
/turf/open/floor/iron/dark/textured,
/area/shuttle/pirate/tiziran_corvette)
"fF" = (
/obj/machinery/modular_computer/preset/engineering{
	dir = 8
	},
/obj/structure/marker_beacon/burgundy,
/turf/open/floor/iron/dark/textured,
/area/shuttle/pirate/tiziran_corvette)
"gG" = (
/obj/machinery/door/airlock/hatch,
/obj/structure/cable,
/obj/machinery/atmospherics/pipe/smart/manifold4w/supply/hidden/layer4,
/obj/effect/mapping_helpers/airlock/cutaiwire,
/turf/open/floor/catwalk_floor/iron_dark,
/area/shuttle/pirate/tiziran_corvette)
"jl" = (
/obj/structure/marker_beacon/burgundy,
/turf/open/floor/catwalk_floor/iron_dark,
/area/shuttle/pirate/tiziran_corvette)
"kd" = (
/obj/machinery/atmospherics/pipe/smart/manifold4w/supply/hidden/layer4,
/obj/machinery/atmospherics/pipe/smart/manifold4w/scrubbers/hidden/layer2,
/obj/structure/cable,
/turf/open/floor/catwalk_floor/iron_dark,
/area/shuttle/pirate/tiziran_corvette)
"kf" = (
/obj/machinery/door/airlock/external{
	id_tag = "pirateforeexternal";
	req_access = list("syndicate")
	},
/obj/structure/cable,
/obj/effect/mapping_helpers/airlock/cutaiwire,
/obj/effect/mapping_helpers/airlock/cyclelink_helper{
	dir = 1
	},
/turf/open/floor/catwalk_floor/iron_dark/airless,
/area/shuttle/pirate/tiziran_corvette)
"kC" = (
/obj/machinery/computer/shuttle/pirate{
	dir = 1
	},
/obj/effect/turf_decal/tile/red/full,
/obj/structure/marker_beacon/burgundy,
/turf/open/floor/iron/dark/textured,
/area/shuttle/pirate/tiziran_corvette)
"lm" = (
/obj/machinery/light/red/directional/south,
/turf/open/floor/plating,
/area/shuttle/pirate/tiziran_corvette)
"lr" = (
/obj/machinery/light/red/directional/east,
/obj/structure/window/reinforced/survival_pod/spawner/directional/north,
/turf/open/floor/plating,
/area/shuttle/pirate/tiziran_corvette)
"lS" = (
/obj/machinery/atmospherics/pipe/smart/manifold4w/supply/hidden/layer4,
/obj/structure/cable,
/turf/open/floor/plating,
/area/shuttle/pirate/tiziran_corvette)
"lW" = (
/obj/machinery/light/red/directional/west,
/obj/structure/shelf,
/obj/item/melee/tizirian_sword{
	pixel_x = -10
	},
/obj/item/melee/tizirian_sword{
	pixel_x = -3
	},
/obj/item/melee/tizirian_sword{
	pixel_x = 5
	},
/turf/open/floor/plating,
/area/shuttle/pirate/tiziran_corvette)
"lY" = (
/obj/machinery/light/red/directional/east,
/obj/structure/kitchenspike,
/turf/open/floor/plating,
/area/shuttle/pirate/tiziran_corvette)
"mJ" = (
/obj/structure/chair/comfy/shuttle,
/obj/effect/turf_decal/tile/red/half{
	dir = 4
	},
/turf/open/floor/iron/dark,
/area/shuttle/pirate/tiziran_corvette)
"mN" = (
/obj/machinery/atmospherics/pipe/smart/manifold4w/supply/hidden/layer4,
/obj/machinery/atmospherics/components/unary/vent_scrubber/on/layer2{
	dir = 1
	},
/obj/machinery/light/red/directional/west,
/turf/open/floor/plating,
/area/shuttle/pirate/tiziran_corvette)
"nt" = (
/obj/machinery/atmospherics/pipe/smart/manifold4w/scrubbers/hidden/layer2,
/obj/machinery/atmospherics/pipe/smart/manifold4w/supply/hidden/layer4,
/turf/open/floor/catwalk_floor/iron_dark,
/area/shuttle/pirate/tiziran_corvette)
"nD" = (
/obj/structure/railing{
	color = "#36373a"
	},
/turf/open/floor/catwalk_floor/iron_dark/airless,
/area/shuttle/pirate/tiziran_corvette)
"og" = (
/obj/structure/cable,
/obj/machinery/atmospherics/pipe/smart/manifold4w/supply/hidden/layer4,
/obj/machinery/atmospherics/pipe/smart/manifold4w/scrubbers/hidden/layer2,
/obj/machinery/power/apc/auto_name/directional/north,
/obj/effect/mapping_helpers/apc/syndicate_access,
/obj/effect/mapping_helpers/apc/cell_10k,
/turf/open/floor/catwalk_floor/iron_dark,
/area/shuttle/pirate/tiziran_corvette)
"oF" = (
/obj/structure/table/reinforced/plastitaniumglass,
/obj/machinery/chem_dispenser/frontier_appliance,
/turf/open/floor/plating,
/area/shuttle/pirate/tiziran_corvette)
"pk" = (
/obj/effect/turf_decal/tile/red/half{
	dir = 8
	},
/obj/machinery/loot_locator,
/turf/open/floor/iron/dark/textured,
/area/shuttle/pirate/tiziran_corvette)
"pF" = (
/obj/machinery/atmospherics/components/unary/vent_pump/on/layer4{
	dir = 8
	},
/turf/open/floor/catwalk_floor/iron_dark,
/area/shuttle/pirate/tiziran_corvette)
"pO" = (
/obj/machinery/atmospherics/components/unary/vent_pump/on/layer4,
/turf/open/floor/plating,
/area/shuttle/pirate/tiziran_corvette)
"pW" = (
/obj/effect/turf_decal/tile/red/half{
	dir = 1
	},
/turf/open/floor/iron/dark,
/area/shuttle/pirate/tiziran_corvette)
"qc" = (
/obj/machinery/power/shuttle_engine/heater{
	dir = 1
	},
/turf/closed/wall/mineral/plastitanium,
/area/shuttle/pirate/tiziran_corvette)
"qp" = (
/obj/machinery/door/airlock/external{
	id_tag = "piratestarboardexternal";
	req_access = list("syndicate")
	},
/obj/machinery/atmospherics/pipe/smart/manifold4w/supply/hidden/layer4,
/obj/effect/mapping_helpers/airlock/cutaiwire,
/obj/effect/mapping_helpers/airlock/cyclelink_helper{
	dir = 8
	},
/turf/open/floor/catwalk_floor/iron_dark,
/area/shuttle/pirate/tiziran_corvette)
"qL" = (
/obj/effect/turf_decal/tile/red/full,
/turf/open/floor/iron/dark,
/area/shuttle/pirate/tiziran_corvette)
"rs" = (
/obj/machinery/airalarm/directional/east,
/obj/effect/mapping_helpers/airalarm/all_access,
/turf/open/floor/plating,
/area/shuttle/pirate/tiziran_corvette)
"rA" = (
/obj/machinery/atmospherics/pipe/smart/manifold4w/scrubbers/hidden/layer2,
/obj/machinery/atmospherics/pipe/smart/manifold4w/supply/hidden/layer4,
/turf/open/floor/plating,
/area/shuttle/pirate/tiziran_corvette)
"te" = (
/obj/item/radio/intercom/syndicate/directional/north,
/obj/structure/cable,
/obj/machinery/atmospherics/pipe/smart/manifold4w/supply/hidden/layer4,
/obj/effect/turf_decal/tile/red{
	dir = 8
	},
/turf/open/floor/iron/dark/smooth_large,
/area/shuttle/pirate/tiziran_corvette)
"tX" = (
/obj/structure/fluff/sat_dish,
/turf/open/floor/catwalk_floor/iron_dark/airless,
/area/shuttle/pirate/tiziran_corvette)
"uo" = (
/obj/machinery/atmospherics/pipe/smart/manifold4w/supply/hidden/layer4,
/obj/machinery/power/micro_reactor,
/obj/structure/cable,
/turf/open/floor/plating,
/area/shuttle/pirate/tiziran_corvette)
"vw" = (
/obj/machinery/deployable_turret/snub_particle_cannon{
	pixel_y = -5
	},
/obj/structure/cable,
/turf/open/floor/catwalk_floor/iron_dark/airless,
/area/shuttle/pirate/tiziran_corvette)
"vV" = (
/obj/machinery/door/airlock/external{
	id_tag = "pirateportexternal";
	req_access = list("syndicate")
	},
/obj/effect/mapping_helpers/airlock/cutaiwire,
/obj/effect/mapping_helpers/airlock/cyclelink_helper{
	dir = 8
	},
/turf/open/floor/catwalk_floor/iron_dark,
/area/shuttle/pirate/tiziran_corvette)
"wq" = (
/obj/machinery/door/airlock/hatch{
	req_access = list("syndicate")
	},
/obj/structure/cable,
/obj/machinery/atmospherics/pipe/smart/manifold4w/supply/hidden/layer4,
/obj/machinery/atmospherics/pipe/smart/manifold4w/scrubbers/hidden/layer2,
/obj/effect/mapping_helpers/airlock/cutaiwire,
/turf/open/floor/catwalk_floor/iron_dark,
/area/shuttle/pirate/tiziran_corvette)
"wI" = (
/obj/effect/mob_spawn/ghost_role/human/pirate/tiziran/captain,
/turf/open/floor/iron/dark,
/area/shuttle/pirate/tiziran_corvette)
"xv" = (
/obj/structure/chair/comfy/shuttle,
/obj/effect/turf_decal/tile/red/full,
/turf/open/floor/iron/dark,
/area/shuttle/pirate/tiziran_corvette)
"xT" = (
/obj/structure/cable,
/obj/machinery/atmospherics/pipe/smart/manifold4w/supply/hidden/layer4,
/obj/machinery/atmospherics/pipe/smart/manifold4w/scrubbers/hidden/layer2,
/obj/machinery/light/red/dim/directional/north,
/obj/machinery/airalarm/directional/north,
/obj/effect/mapping_helpers/airalarm/all_access,
/turf/open/floor/iron/dark,
/area/shuttle/pirate/tiziran_corvette)
"yj" = (
/obj/structure/cable,
/turf/open/floor/catwalk_floor/iron_dark/airless,
/area/shuttle/pirate/tiziran_corvette)
"yW" = (
/turf/open/floor/catwalk_floor/iron_dark,
/area/shuttle/pirate/tiziran_corvette)
"zh" = (
/obj/structure/cable,
/turf/open/floor/catwalk_floor/iron_dark,
/area/shuttle/pirate/tiziran_corvette)
"zv" = (
/obj/structure/shelf,
/obj/item/ammo_box/magazine/ammo_stack/bolt_slug/full{
	pixel_x = 2;
	pixel_y = -1
	},
/obj/item/ammo_box/magazine/ammo_stack/bolt_slug/full,
/obj/item/ammo_box/magazine/ammo_stack/bolt_slug/full{
	pixel_x = -2;
	pixel_y = 1
	},
/obj/item/ammo_box/magazine/ammo_stack/bolt_slug/full{
	pixel_x = -4;
	pixel_y = 2
	},
/obj/item/ammo_box/magazine/ammo_stack/bolt_slug/full{
	pixel_x = -6;
	pixel_y = 3
	},
/obj/item/ammo_box/magazine/ammo_stack/bolt_slug/full{
	pixel_x = -8;
	pixel_y = 4
	},
/turf/open/floor/plating,
/area/shuttle/pirate/tiziran_corvette)
"zR" = (
/obj/machinery/computer/monitor{
	dir = 1
	},
/turf/open/floor/iron/dark/textured,
/area/shuttle/pirate/tiziran_corvette)
"zX" = (
/obj/structure/chair/comfy/shuttle,
/obj/effect/turf_decal/tile/red/half{
	dir = 8
	},
/turf/open/floor/iron/dark,
/area/shuttle/pirate/tiziran_corvette)
"At" = (
/obj/machinery/atmospherics/pipe/smart/manifold4w/supply/hidden/layer4,
/obj/machinery/atmospherics/pipe/smart/manifold4w/scrubbers/hidden/layer2,
/obj/machinery/light/red/directional/south,
/turf/open/floor/catwalk_floor/iron_dark,
/area/shuttle/pirate/tiziran_corvette)
"AC" = (
/obj/machinery/modular_computer/preset/engineering{
	dir = 1
	},
/obj/effect/turf_decal/tile/red/half{
	dir = 4
	},
/turf/open/floor/iron/dark/textured,
/area/shuttle/pirate/tiziran_corvette)
"AT" = (
/obj/structure/cable,
/obj/machinery/atmospherics/pipe/smart/manifold4w/supply/hidden/layer4,
/obj/machinery/atmospherics/pipe/smart/manifold4w/scrubbers/hidden/layer2,
/obj/structure/chair/plastic{
	dir = 4
	},
/turf/open/floor/catwalk_floor/iron_dark,
/area/shuttle/pirate/tiziran_corvette)
"AW" = (
/obj/machinery/atmospherics/components/unary/vent_pump/on/layer4{
	dir = 8
	},
/obj/machinery/light/red/directional/north,
/turf/open/floor/plating,
/area/shuttle/pirate/tiziran_corvette)
"Ba" = (
/obj/structure/railing{
	color = "#36373a";
	dir = 10
	},
/obj/structure/cable,
/turf/open/floor/catwalk_floor/iron_dark/airless,
/area/shuttle/pirate/tiziran_corvette)
"Bf" = (
/obj/machinery/suit_storage_unit/tiziran_raiders/yellow,
/turf/open/floor/plating,
/area/shuttle/pirate/tiziran_corvette)
"Bi" = (
/obj/machinery/computer/camera_advanced/shuttle_docker/syndicate/pirate{
	dir = 1;
	x_offset = 12;
	y_offset = 5;
	view_range = 10
	},
/turf/open/floor/iron/dark/textured,
/area/shuttle/pirate/tiziran_corvette)
"BS" = (
/turf/closed/wall/mineral/plastitanium,
/area/shuttle/pirate/tiziran_corvette)
"CE" = (
/obj/machinery/atmospherics/pipe/smart/manifold4w/scrubbers/hidden/layer2,
/obj/machinery/atmospherics/pipe/smart/manifold4w/supply/hidden/layer4,
/obj/structure/cable,
/turf/open/floor/catwalk_floor/iron_dark,
/area/shuttle/pirate/tiziran_corvette)
"Dl" = (
/obj/structure/cable,
/obj/machinery/atmospherics/pipe/smart/manifold4w/supply/hidden/layer4,
/turf/open/floor/catwalk_floor/iron_dark,
/area/shuttle/pirate/tiziran_corvette)
"Dp" = (
/obj/structure/cable,
/obj/machinery/atmospherics/pipe/smart/manifold4w/supply/hidden/layer4,
/turf/open/floor/plating,
/area/shuttle/pirate/tiziran_corvette)
"Dv" = (
/obj/structure/closet/crate/secure/plasma,
/obj/item/stack/sheet/mineral/plasma/five,
/obj/item/stack/sheet/mineral/plasma/five,
/turf/open/floor/plating,
/area/shuttle/pirate/tiziran_corvette)
"DH" = (
/obj/machinery/atmospherics/pipe/smart/manifold4w/supply/hidden/layer4,
/obj/machinery/atmospherics/components/unary/vent_scrubber/on/layer2{
	dir = 8
	},
/turf/open/floor/catwalk_floor/iron_dark,
/area/shuttle/pirate/tiziran_corvette)
"Em" = (
/obj/structure/table/reinforced/plastitaniumglass,
/obj/item/reagent_containers/cup/glass/trophy{
	pixel_y = 20;
	pixel_x = -8
	},
/obj/effect/turf_decal/tile/red/half{
	dir = 4
	},
/obj/item/clothing/head/helmet/skull{
	pixel_x = 5;
	pixel_y = -3
	},
/obj/machinery/atmospherics/components/unary/vent_scrubber/on/layer2{
	dir = 4
	},
/turf/open/floor/iron/dark/smooth_half,
/area/shuttle/pirate/tiziran_corvette)
"EI" = (
/obj/machinery/suit_storage_unit/tiziran_raiders/red,
/turf/open/floor/plating,
/area/shuttle/pirate/tiziran_corvette)
"FQ" = (
/obj/structure/girder/reinforced,
/turf/open/floor/plating,
/area/shuttle/pirate/tiziran_corvette)
"GE" = (
/obj/machinery/atmospherics/pipe/smart/manifold4w/supply/hidden/layer4,
/obj/machinery/atmospherics/pipe/smart/manifold4w/scrubbers/hidden/layer2,
/obj/machinery/airalarm/directional/west,
/obj/effect/mapping_helpers/airalarm/all_access,
/turf/open/floor/catwalk_floor/iron_dark,
/area/shuttle/pirate/tiziran_corvette)
"GI" = (
/obj/structure/sign/poster/ripped/directional/west,
/obj/effect/mob_spawn/ghost_role/human/pirate/tiziran,
/obj/machinery/light/red/directional/west,
/obj/machinery/atmospherics/components/unary/vent_pump/on/layer4{
	dir = 4
	},
/turf/open/floor/iron/dark,
/area/shuttle/pirate/tiziran_corvette)
"Id" = (
/obj/machinery/atmospherics/components/unary/vent_pump/on/layer4{
	dir = 8
	},
/obj/structure/table/reinforced/plastitaniumglass,
/obj/item/reagent_containers/cup/glass/bottle/lizardwine{
	pixel_x = -4;
	pixel_y = 5
	},
/obj/item/reagent_containers/cup/glass/trophy{
	pixel_x = 7;
	pixel_y = 7
	},
/obj/machinery/light/red/directional/east,
/turf/open/floor/iron/dark,
/area/shuttle/pirate/tiziran_corvette)
"Il" = (
/obj/machinery/oven/range_frontier,
/turf/open/floor/plating,
/area/shuttle/pirate/tiziran_corvette)
"In" = (
/turf/open/floor/plating,
/area/shuttle/pirate/tiziran_corvette)
"Is" = (
/obj/machinery/door/airlock/external{
	id_tag = "pirateportexternal";
	req_access = list("syndicate")
	},
/obj/machinery/atmospherics/pipe/smart/manifold4w/scrubbers/hidden/layer2,
/obj/machinery/atmospherics/pipe/smart/manifold4w/supply/hidden/layer4,
/obj/effect/mapping_helpers/airlock/cutaiwire,
/obj/effect/mapping_helpers/airlock/cyclelink_helper{
	dir = 1
	},
/turf/open/floor/plating,
/area/shuttle/pirate/tiziran_corvette)
"IB" = (
/obj/machinery/suit_storage_unit/tiziran_raiders,
/turf/open/floor/plating,
/area/shuttle/pirate/tiziran_corvette)
"IN" = (
/obj/machinery/door/airlock/external{
	id_tag = "pirateportexternal";
	req_access = list("syndicate")
	},
/obj/machinery/atmospherics/pipe/smart/manifold4w/supply/hidden/layer4,
/obj/machinery/atmospherics/pipe/smart/manifold4w/scrubbers/hidden/layer2,
/obj/effect/mapping_helpers/airlock/cutaiwire,
/obj/effect/mapping_helpers/airlock/cyclelink_helper,
/turf/open/floor/catwalk_floor/iron_dark,
/area/shuttle/pirate/tiziran_corvette)
"IS" = (
/obj/machinery/power/shuttle_engine/propulsion{
	dir = 1
	},
/turf/open/floor/plating/airless,
/area/shuttle/pirate/tiziran_corvette)
"Ja" = (
/turf/closed/wall/mineral/plastitanium/nodiagonal,
/area/shuttle/pirate/tiziran_corvette)
"Jc" = (
/obj/machinery/atmospherics/components/unary/vent_scrubber/on/layer2{
	dir = 4
	},
/obj/machinery/airalarm/directional/north,
/obj/effect/mapping_helpers/airalarm/all_access,
/obj/structure/shelf,
/obj/item/grenade/firecracker{
	pixel_x = -6;
	pixel_y = 6
	},
/obj/item/grenade/firecracker{
	pixel_x = -6;
	pixel_y = 8
	},
/obj/item/grenade/firecracker{
	pixel_x = -6;
	pixel_y = 10
	},
/obj/item/lighter/skull{
	pixel_x = -6;
	pixel_y = -8
	},
/obj/item/grenade/firecracker{
	pixel_x = 6;
	pixel_y = -4
	},
/obj/item/grenade/firecracker{
	pixel_x = 6;
	pixel_y = -2
	},
/obj/item/grenade/firecracker{
	pixel_x = 6
	},
/turf/open/floor/plating,
/area/shuttle/pirate/tiziran_corvette)
"Je" = (
/obj/structure/table/reinforced/plastitaniumglass,
/turf/open/floor/plating,
/area/shuttle/pirate/tiziran_corvette)
"JW" = (
/obj/structure/tank_dispenser/oxygen,
/turf/open/floor/plating,
/area/shuttle/pirate/tiziran_corvette)
"La" = (
/obj/machinery/atmospherics/components/unary/vent_scrubber/on/layer2{
	dir = 1
	},
/turf/open/floor/iron/dark,
/area/shuttle/pirate/tiziran_corvette)
"LG" = (
/obj/machinery/atmospherics/components/unary/vent_pump/on/layer4{
	dir = 4
	},
/turf/open/floor/catwalk_floor/iron_dark,
/area/shuttle/pirate/tiziran_corvette)
"LS" = (
/obj/effect/turf_decal/tile/red/half{
	dir = 8
	},
/obj/machinery/atmospherics/pipe/smart/manifold4w/scrubbers/hidden/layer2,
/turf/open/floor/iron/dark/smooth_half,
/area/shuttle/pirate/tiziran_corvette)
"Mp" = (
/obj/machinery/atmospherics/pipe/smart/manifold4w/supply/hidden/layer4,
/obj/structure/cable,
/obj/machinery/airalarm/directional/west,
/obj/effect/mapping_helpers/airalarm/all_access,
/turf/open/floor/plating,
/area/shuttle/pirate/tiziran_corvette)
"MV" = (
/obj/structure/sign/poster/contraband/dolphin/directional/east,
/obj/machinery/vending/imported/tiziran,
/turf/open/floor/plating,
/area/shuttle/pirate/tiziran_corvette)
"MZ" = (
/turf/template_noop,
/area/template_noop)
"Nx" = (
/obj/structure/cable,
/obj/machinery/atmospherics/pipe/smart/manifold4w/supply/hidden/layer4,
/obj/machinery/atmospherics/pipe/smart/manifold4w/scrubbers/hidden/layer2,
/turf/open/floor/iron/dark,
/area/shuttle/pirate/tiziran_corvette)
"NK" = (
/obj/effect/mob_spawn/ghost_role/human/pirate/tiziran,
/obj/structure/sign/poster/contraband/lizard/directional/south,
/turf/open/floor/iron/dark,
/area/shuttle/pirate/tiziran_corvette)
"QC" = (
/obj/machinery/door/poddoor/shutters/preopen{
	id = "piratebridge"
	},
/obj/effect/spawner/structure/window/reinforced/plasma/plastitanium,
/obj/structure/cable,
/turf/open/floor/plating,
/area/shuttle/pirate/tiziran_corvette)
"Ra" = (
/obj/machinery/computer/monitor{
	dir = 1
	},
/obj/structure/cable,
/obj/structure/marker_beacon/burgundy,
/turf/open/floor/iron/dark/textured,
/area/shuttle/pirate/tiziran_corvette)
"Rf" = (
/obj/machinery/power/port_gen/pacman/pre_loaded,
/obj/structure/cable,
/obj/machinery/light/red/directional/east,
/turf/open/floor/plating,
/area/shuttle/pirate/tiziran_corvette)
"Rm" = (
/obj/machinery/light/red/directional/west,
/turf/open/floor/plating,
/area/shuttle/pirate/tiziran_corvette)
"RO" = (
/obj/structure/barricade/wooden/crude,
/turf/open/floor/plating,
/area/shuttle/pirate/tiziran_corvette)
"SA" = (
/obj/machinery/atmospherics/pipe/smart/manifold4w/supply/hidden/layer4,
/obj/structure/cable,
/obj/machinery/airalarm/directional/north,
/obj/effect/mapping_helpers/airalarm/all_access,
/turf/open/floor/catwalk_floor/iron_dark,
/area/shuttle/pirate/tiziran_corvette)
"SG" = (
/obj/machinery/atmospherics/pipe/smart/manifold4w/supply/hidden/layer4,
/obj/machinery/atmospherics/pipe/smart/manifold4w/scrubbers/hidden/layer2,
/turf/open/floor/catwalk_floor/iron_dark,
/area/shuttle/pirate/tiziran_corvette)
"SI" = (
/obj/structure/railing/eva_handhold/directional/west,
/turf/closed/wall/mineral/plastitanium,
/area/shuttle/pirate/tiziran_corvette)
"Ti" = (
/obj/structure/shelf,
/obj/item/gun/ballistic/bolt_thrower{
	pixel_x = 4;
	pixel_y = -8
	},
/obj/item/gun/ballistic/bolt_thrower{
	pixel_x = 2;
	pixel_y = -4
	},
/obj/item/gun/ballistic/bolt_thrower,
/turf/open/floor/plating,
/area/shuttle/pirate/tiziran_corvette)
"Tv" = (
/obj/structure/cable,
/obj/structure/sign/flag/tizira/directional/north,
/obj/machinery/atmospherics/pipe/smart/manifold4w/supply/hidden/layer4,
/obj/effect/turf_decal/tile/red,
/obj/machinery/atmospherics/pipe/smart/manifold4w/scrubbers/hidden/layer2,
/turf/open/floor/iron/dark/smooth_large,
/area/shuttle/pirate/tiziran_corvette)
"TK" = (
/obj/machinery/porta_turret/syndicate,
/turf/closed/wall/mineral/plastitanium,
/area/shuttle/pirate/tiziran_corvette)
"Un" = (
/obj/structure/cable,
/obj/machinery/atmospherics/pipe/smart/manifold4w/supply/hidden/layer4,
/obj/effect/turf_decal/tile/red/half,
/obj/machinery/atmospherics/pipe/smart/manifold4w/scrubbers/hidden/layer2,
/turf/open/floor/iron/dark/smooth_large,
/area/shuttle/pirate/tiziran_corvette)
"Vi" = (
/obj/structure/cable,
/obj/machinery/atmospherics/pipe/smart/manifold4w/supply/hidden/layer4,
/obj/machinery/atmospherics/pipe/smart/manifold4w/scrubbers/hidden/layer2,
/turf/open/floor/catwalk_floor/iron_dark,
/area/shuttle/pirate/tiziran_corvette)
"VT" = (
/obj/structure/cable,
/obj/structure/marker_beacon/burgundy,
/turf/open/floor/catwalk_floor/iron_dark,
/area/shuttle/pirate/tiziran_corvette)
"VY" = (
/obj/machinery/door/airlock/hatch,
/obj/structure/cable,
/obj/machinery/atmospherics/pipe/smart/manifold4w/supply/hidden/layer4,
/obj/machinery/atmospherics/pipe/smart/manifold4w/scrubbers/hidden/layer2,
/obj/effect/mapping_helpers/airlock/cutaiwire,
/turf/open/floor/catwalk_floor/iron_dark,
/area/shuttle/pirate/tiziran_corvette)
"Xj" = (
/obj/machinery/atmospherics/components/unary/vent_pump/on/layer4{
	dir = 8
	},
/obj/structure/chair/plastic{
	dir = 1
	},
/turf/open/floor/plating,
/area/shuttle/pirate/tiziran_corvette)
"Xw" = (
/obj/structure/railing/eva_handhold/directional/east,
/turf/closed/wall/mineral/plastitanium,
/area/shuttle/pirate/tiziran_corvette)
"XN" = (
/obj/machinery/atmospherics/components/unary/vent_pump/on/layer4{
	dir = 8
	},
/turf/open/floor/plating,
/area/shuttle/pirate/tiziran_corvette)
"Yq" = (
/obj/structure/cable,
/obj/machinery/atmospherics/pipe/smart/manifold4w/scrubbers/hidden/layer2,
/obj/machinery/atmospherics/pipe/smart/manifold4w/supply/hidden/layer4,
/turf/open/floor/catwalk_floor/iron_dark,
/area/shuttle/pirate/tiziran_corvette)
"ZK" = (
/obj/machinery/atmospherics/pipe/smart/manifold4w/supply/hidden/layer4,
/turf/open/floor/catwalk_floor/iron_dark,
/area/shuttle/pirate/tiziran_corvette)

(1,1,1) = {"
MZ
MZ
MZ
MZ
MZ
MZ
MZ
SI
ee
bn
Ja
Ja
BS
MZ
MZ
BS
Ja
TK
MZ
MZ
MZ
MZ
"}
(2,1,1) = {"
MZ
MZ
MZ
MZ
MZ
MZ
BS
Ja
LG
Ja
In
In
Ja
BS
BS
Ja
In
Ja
BS
MZ
MZ
MZ
"}
(3,1,1) = {"
MZ
MZ
MZ
MZ
MZ
BS
Ja
Ja
qp
Ja
Dl
Dl
gG
Dp
RO
In
In
FQ
Ja
BS
MZ
MZ
"}
(4,1,1) = {"
MZ
MZ
MZ
MZ
BS
Ja
JW
Rm
ZK
ZK
Dl
lm
Ja
AW
FQ
In
In
In
FQ
Ja
TK
MZ
"}
(5,1,1) = {"
MZ
MZ
MZ
BS
Ja
Jc
Dl
ZK
ZK
Bf
Ja
BS
BS
Ja
rs
In
In
FQ
In
In
Ja
BS
"}
(6,1,1) = {"
MZ
MZ
do
Ja
lW
nt
Vi
EI
IB
Ja
BS
MZ
MZ
BS
Ja
Ja
Ja
Ja
Ja
Ja
Ja
Ja
"}
(7,1,1) = {"
MZ
IS
qc
Ti
In
CE
nt
Ja
Ja
TK
MZ
MZ
MZ
MZ
MZ
MZ
MZ
MZ
MZ
MZ
MZ
MZ
"}
(8,1,1) = {"
MZ
IS
qc
zv
In
kd
Yq
bB
yj
kf
Ba
MZ
MZ
MZ
MZ
MZ
MZ
MZ
MZ
MZ
MZ
MZ
"}
(9,1,1) = {"
IS
qc
Ja
Ja
Ja
Ja
ce
Ja
Ja
BS
vw
MZ
MZ
MZ
MZ
MZ
MZ
MZ
MZ
MZ
MZ
MZ
"}
(10,1,1) = {"
IS
qc
GI
NK
Ja
Vi
zh
VT
Ra
QC
nD
MZ
MZ
MZ
MZ
MZ
MZ
MZ
MZ
MZ
MZ
MZ
"}
(11,1,1) = {"
IS
qc
Nx
La
Ja
og
yW
mJ
AC
QC
QC
MZ
MZ
MZ
MZ
MZ
MZ
MZ
MZ
MZ
MZ
MZ
"}
(12,1,1) = {"
MZ
BS
eq
Ja
Ja
Tv
Em
pW
ex
zR
QC
MZ
MZ
MZ
MZ
MZ
MZ
MZ
MZ
MZ
MZ
MZ
"}
(13,1,1) = {"
MZ
BS
xT
Nx
VY
Un
eY
qL
xv
kC
QC
MZ
MZ
MZ
MZ
MZ
MZ
MZ
MZ
MZ
MZ
MZ
"}
(14,1,1) = {"
MZ
BS
ao
Ja
Ja
te
LS
pW
fF
Bi
QC
MZ
MZ
MZ
MZ
MZ
MZ
MZ
MZ
MZ
MZ
MZ
"}
(15,1,1) = {"
IS
qc
Nx
cv
Ja
SA
Vi
zX
pk
QC
QC
MZ
MZ
MZ
MZ
MZ
MZ
MZ
MZ
MZ
MZ
MZ
"}
(16,1,1) = {"
IS
qc
Id
wI
Ja
pF
Vi
zh
fA
QC
MZ
MZ
MZ
MZ
MZ
MZ
MZ
MZ
MZ
MZ
MZ
MZ
"}
(17,1,1) = {"
IS
qc
Ja
Ja
Ja
Ja
Vi
jl
Ja
BS
MZ
MZ
MZ
MZ
MZ
MZ
MZ
MZ
MZ
MZ
MZ
MZ
"}
(18,1,1) = {"
MZ
IS
qc
uo
Dv
Ja
wq
Ja
BS
tX
MZ
MZ
MZ
MZ
MZ
MZ
MZ
MZ
MZ
MZ
MZ
MZ
"}
(19,1,1) = {"
MZ
IS
qc
lS
lS
Mp
Vi
In
Ja
TK
MZ
MZ
MZ
MZ
MZ
MZ
MZ
MZ
MZ
MZ
MZ
MZ
"}
(20,1,1) = {"
MZ
MZ
do
Ja
Rf
In
Vi
In
In
Ja
BS
MZ
MZ
BS
Ja
Ja
Ja
Ja
Ja
Ja
Ja
Ja
"}
(21,1,1) = {"
MZ
MZ
MZ
BS
Ja
MV
AT
SG
SG
In
Ja
BS
BS
Ja
rA
Is
rA
mN
In
In
Ja
BS
"}
(22,1,1) = {"
MZ
MZ
MZ
MZ
BS
Ja
dO
Xj
SG
SG
SG
SG
IN
GE
At
Ja
FQ
XN
FQ
Ja
TK
MZ
"}
(23,1,1) = {"
MZ
MZ
MZ
MZ
MZ
BS
Ja
Ja
Je
In
oF
cE
Ja
pO
DH
Ja
RO
FQ
Ja
BS
MZ
MZ
"}
(24,1,1) = {"
MZ
MZ
MZ
MZ
MZ
MZ
BS
Ja
lY
In
Il
lr
Ja
Xw
vV
Ja
In
Ja
BS
MZ
MZ
MZ
"}
(25,1,1) = {"
MZ
MZ
MZ
MZ
MZ
MZ
MZ
BS
Ja
Ja
Ja
Ja
BS
MZ
MZ
BS
Ja
TK
MZ
MZ
MZ
MZ
"}
