//MAP CONVERTED BY dmm2tgm.py THIS HEADER COMMENT PREVENTS RECONVERSION, DO NOT REMOVE
"ao" = (
/obj/machinery/door/airlock/hatch,
/obj/structure/cable,
/obj/machinery/atmospherics/pipe/smart/manifold4w/supply/hidden{
	dir = 4
	},
/turf/open/floor/iron/dark,
/area/space)
"bn" = (
/turf/closed/wall/mineral/plastitanium,
/area/space)
"cv" = (
/obj/structure/cable,
/obj/machinery/atmospherics/pipe/smart/manifold4w/supply/hidden{
	dir = 4
	},
/obj/effect/turf_decal/tile/red/half,
/turf/open/floor/iron/dark/smooth_large,
/area/space)
"cE" = (
/obj/machinery/space_heater,
/turf/open/floor/plating,
/area/space)
"do" = (
/obj/machinery/turretid{
	ailock = 1;
	desc = d"A specially designed set of turret controls. Looks to be covered in protective casing to prevent AI interfacing.";
	icon_state = "control_kill";
	lethal = 1;
	name = "Ship Turret Control";
	pixel_x = 30;
	pixel_y = 4;
	req_access = list("syndicate")
	},
/obj/machinery/shuttle_scrambler,
/turf/open/floor/iron/dark/textured,
/area/space)
"dO" = (
/obj/effect/turf_decal/tile/red/half{
	dir = 1
	},
/turf/open/floor/iron/dark/smooth_corner{
	dir = 1
	},
/area/space)
"ee" = (
/obj/structure/cable,
/obj/machinery/atmospherics/pipe/smart/manifold4w/supply/hidden{
	dir = 4
	},
/obj/effect/turf_decal/tile/red/half{
	dir = 1
	},
/turf/open/floor/iron/dark,
/area/space)
"ex" = (
/obj/effect/turf_decal/tile/red/half{
	dir = 1
	},
/turf/open/floor/iron/dark/smooth_corner{
	dir = 4
	},
/area/space)
"eY" = (
/obj/structure/window/reinforced/survival_pod/spawner/directional/north,
/turf/open/floor/plating,
/area/space)
"fA" = (
/obj/structure/railing{
	color = "#36373a";
	dir = 6
	},
/obj/effect/turf_decal/tile/red/half{
	dir = 1
	},
/obj/structure/marker_beacon/burgundy,
/turf/open/floor/iron/dark/smooth_corner,
/area/space)
"fF" = (
/obj/structure/railing{
	color = "#36373a"
	},
/obj/effect/turf_decal/tile/red{
	dir = 1
	},
/turf/open/floor/iron/dark/smooth_half,
/area/space)
"gG" = (
/obj/machinery/door/airlock/external,
/turf/open/floor/iron/dark/textured,
/area/space)
"ht" = (
/obj/structure/railing/eva_handhold/directional/west,
/turf/closed/wall/mineral/plastitanium,
/area/space)
"iJ" = (
/obj/structure/chair/plastic{
	dir = 1
	},
/turf/open/floor/plating,
/area/space)
"jl" = (
/obj/machinery/power/micro_reactor,
/turf/open/floor/iron/dark,
/area/space)
"kd" = (
/obj/machinery/door/airlock/hatch,
/obj/structure/cable,
/obj/machinery/atmospherics/pipe/smart/manifold4w/supply/hidden{
	dir = 4
	},
/turf/open/floor/catwalk_floor/iron_dark,
/area/space)
"kC" = (
/obj/structure/minecart_rail,
/turf/template_noop,
/area/space)
"lr" = (
/obj/structure/barricade/wooden/crude,
/turf/open/floor/plating,
/area/space)
"lS" = (
/obj/item/radio/intercom/syndicate/directional/north,
/obj/structure/cable,
/obj/machinery/atmospherics/pipe/smart/manifold4w/supply/hidden{
	dir = 4
	},
/obj/effect/turf_decal/tile/red{
	dir = 8
	},
/turf/open/floor/iron/dark/smooth_large,
/area/space)
"nD" = (
/obj/machinery/porta_turret/syndicate{
	dir = 1
	},
/turf/closed/wall/mineral/plastitanium,
/area/space)
"oS" = (
/obj/machinery/vending/imported/tiziran,
/turf/open/floor/plating,
/area/space)
"pF" = (
/obj/machinery/modular_computer/preset/engineering{
	dir = 8
	},
/turf/open/floor/iron/dark/textured,
/area/space)
"pO" = (
/obj/machinery/modular_computer/preset/engineering{
	dir = 4
	},
/turf/open/floor/iron/dark,
/area/space)
"pW" = (
/turf/open/floor/catwalk_floor/iron_dark/airless,
/area/space)
"qc" = (
/obj/structure/chair/bronze,
/turf/open/floor/iron/dark/smooth_half,
/area/space)
"qm" = (
/obj/machinery/atmospherics/pipe/smart/manifold4w/supply/hidden{
	dir = 4
	},
/obj/structure/cable,
/turf/open/floor/catwalk_floor/iron_dark,
/area/space)
"qp" = (
/obj/structure/girder/reinforced,
/obj/structure/barricade/wooden/crude,
/turf/open/floor/plating,
/area/space)
"rA" = (
/obj/machinery/power/port_gen/pacman/pre_loaded,
/obj/structure/cable,
/turf/open/floor/iron/dark,
/area/space)
"te" = (
/obj/structure/table/reinforced/plastitaniumglass,
/obj/machinery/button/door{
	id = "silverbridge";
	name = "Window Shutters Control"
	},
/turf/open/floor/iron/dark/textured,
/area/space)
"tX" = (
/obj/machinery/power/shuttle_engine/heater{
	dir = 1
	},
/turf/closed/wall/mineral/plastitanium,
/area/space)
"uo" = (
/obj/effect/turf_decal/tile/red/half{
	dir = 8
	},
/turf/open/floor/iron/dark,
/area/space)
"vw" = (
/obj/machinery/loot_locator,
/obj/effect/turf_decal/tile/red/half{
	dir = 8
	},
/turf/open/floor/iron/dark/textured,
/area/space)
"vV" = (
/obj/structure/window/reinforced/survival_pod/spawner/directional/west,
/turf/open/floor/plating,
/area/space)
"wF" = (
/obj/structure/cable,
/obj/machinery/atmospherics/pipe/smart/manifold4w/supply/hidden{
	dir = 4
	},
/turf/open/floor/catwalk_floor/iron_dark,
/area/space)
"wI" = (
/obj/structure/railing{
	color = "#36373a"
	},
/obj/effect/turf_decal/tile/red/full,
/turf/open/floor/iron/dark/smooth_half,
/area/space)
"xm" = (
/obj/structure/chair/comfy/shuttle,
/obj/effect/turf_decal/tile/red/half{
	dir = 4
	},
/turf/open/floor/iron/dark,
/area/space)
"yj" = (
/obj/machinery/computer/shuttle/pirate{
	dir = 1
	},
/obj/effect/turf_decal/tile/red/full,
/turf/open/floor/iron/dark/textured,
/area/space)
"yW" = (
/obj/structure/shelf,
/obj/item/grenade/firecracker{
	pixel_x = -6;
	pixel_y = 6
	},
/obj/item/grenade/firecracker{
	pixel_x = -6;
	pixel_y = 8
	},
/obj/item/grenade/firecracker{
	pixel_x = -6;
	pixel_y = 10
	},
/obj/item/lighter/skull{
	pixel_x = -6;
	pixel_y = -8
	},
/obj/item/grenade/firecracker{
	pixel_x = 6;
	pixel_y = -4
	},
/obj/item/grenade/firecracker{
	pixel_x = 6;
	pixel_y = -2
	},
/obj/item/grenade/firecracker{
	pixel_x = 6
	},
/turf/open/floor/plating,
/area/space)
"zh" = (
/obj/machinery/deployable_turret/snub_particle_cannon{
	pixel_y = -5
	},
/turf/open/floor/catwalk_floor/iron_dark/airless,
/area/space)
"zk" = (
/obj/effect/turf_decal/tile/red/half{
	dir = 1
	},
/turf/open/floor/iron/dark,
/area/space)
"zv" = (
/obj/structure/cable,
/obj/machinery/atmospherics/pipe/smart/manifold4w/supply/hidden{
	dir = 4
	},
/turf/open/floor/plating,
/area/space)
"zT" = (
/obj/structure/railing/eva_handhold/directional/east,
/turf/closed/wall/mineral/plastitanium,
/area/space)
"zX" = (
/obj/structure/shelf,
/turf/open/floor/plating,
/area/space)
"Ag" = (
/obj/machinery/power/shuttle_engine/propulsion{
	dir = 1
	},
/turf/open/floor/plating/airless,
/area/space)
"At" = (
/obj/effect/turf_decal/tile/red/full,
/turf/open/floor/iron/dark,
/area/space)
"AC" = (
/obj/machinery/door/poddoor/shutters/preopen{
	id = "piratebridge"
	},
/obj/effect/spawner/structure/window/reinforced/plasma/plastitanium,
/turf/open/floor/plating,
/area/space)
"AT" = (
/obj/structure/table/reinforced/plastitaniumglass,
/obj/item/reagent_containers/cup/glass/trophy{
	pixel_y = 20;
	pixel_x = -8
	},
/obj/effect/turf_decal/tile/red/half{
	dir = 4
	},
/obj/item/clothing/head/helmet/skull{
	pixel_x = 5;
	pixel_y = -3
	},
/turf/open/floor/iron/dark/smooth_half,
/area/space)
"Ba" = (
/turf/open/floor/iron/dark,
/area/space)
"Bf" = (
/obj/machinery/porta_turret/syndicate,
/turf/closed/wall/mineral/plastitanium,
/area/space)
"Bi" = (
/obj/structure/cable,
/turf/open/floor/iron/dark,
/area/space)
"Bm" = (
/obj/structure/girder/reinforced,
/turf/open/floor/plating,
/area/space)
"Dl" = (
/obj/structure/fluff/sat_dish,
/turf/open/floor/catwalk_floor/iron_dark/airless,
/area/space)
"Dv" = (
/obj/structure/chair/comfy/shuttle,
/obj/effect/turf_decal/tile/red/half{
	dir = 8
	},
/turf/open/floor/iron/dark,
/area/space)
"DB" = (
/obj/machinery/atmospherics/components/tank/air{
	dir = 1
	},
/turf/open/floor/plating,
/area/space)
"Em" = (
/obj/machinery/atmospherics/pipe/smart/manifold4w/supply/hidden{
	dir = 4
	},
/turf/open/floor/catwalk_floor/iron_dark,
/area/space)
"EI" = (
/obj/structure/minecart_rail,
/obj/structure/marker_beacon/burgundy{
	pixel_x = 6;
	pixel_y = -14
	},
/obj/structure/marker_beacon/olive{
	pixel_x = -6;
	pixel_y = -14
	},
/turf/template_noop,
/area/space)
"Fd" = (
/obj/machinery/modular_computer/preset/engineering{
	dir = 1
	},
/obj/effect/turf_decal/tile/red/half{
	dir = 8
	},
/turf/open/floor/iron/dark/textured,
/area/space)
"GI" = (
/obj/structure/chair/plastic{
	dir = 4
	},
/turf/open/floor/plating,
/area/space)
"In" = (
/turf/closed/wall/mineral/plastitanium/nodiagonal,
/area/space)
"Is" = (
/obj/structure/closet/crate/secure/plasma,
/obj/item/stack/sheet/mineral/plasma/five,
/turf/open/floor/iron/dark,
/area/space)
"IB" = (
/obj/item/rolling_table_dock,
/obj/effect/spawner/random/vendor_meal_sides/tizira,
/obj/item/reagent_containers/condiment/pack/ketchup{
	pixel_y = 7;
	pixel_x = -9
	},
/turf/open/floor/plating,
/area/space)
"IS" = (
/obj/structure/chair/comfy/shuttle{
	dir = 4
	},
/turf/open/floor/iron/dark,
/area/space)
"Ja" = (
/obj/machinery/door/airlock/external,
/turf/open/floor/catwalk_floor/iron_dark/airless,
/area/space)
"Je" = (
/obj/structure/railing{
	color = "#36373a";
	dir = 10
	},
/turf/open/floor/catwalk_floor/iron_dark/airless,
/area/space)
"JM" = (
/obj/structure/shelf,
/obj/item/gun/ballistic/rifle/bolt_thrower,
/obj/item/gun/ballistic/rifle/bolt_thrower{
	pixel_y = 5;
	pixel_x = -4
	},
/obj/item/gun/ballistic/rifle/bolt_thrower{
	pixel_y = 10;
	pixel_x = -8
	},
/turf/open/floor/plating,
/area/space)
"JW" = (
/obj/structure/railing{
	color = "#36373a";
	dir = 10
	},
/obj/effect/turf_decal/tile/red/half{
	dir = 1
	},
/obj/structure/marker_beacon/burgundy,
/turf/open/floor/iron/dark/smooth_corner{
	dir = 8
	},
/area/space)
"LG" = (
/turf/open/floor/plating,
/area/space)
"LS" = (
/obj/machinery/computer/monitor{
	dir = 1
	},
/turf/open/floor/iron/dark/textured,
/area/space)
"MZ" = (
/turf/template_noop,
/area/space)
"QC" = (
/obj/structure/cable,
/obj/machinery/atmospherics/pipe/smart/manifold4w/supply/hidden{
	dir = 4
	},
/turf/open/floor/iron/dark,
/area/space)
"Rf" = (
/turf/open/floor/catwalk_floor/iron_dark,
/area/space)
"RO" = (
/obj/structure/window/reinforced/survival_pod/spawner/directional/west,
/obj/structure/shelf,
/turf/open/floor/plating,
/area/space)
"Sf" = (
/obj/structure/tank_dispenser/oxygen,
/turf/open/floor/plating,
/area/space)
"SA" = (
/obj/structure/chair/comfy/shuttle,
/obj/effect/turf_decal/tile/red/full,
/turf/open/floor/iron/dark,
/area/space)
"SG" = (
/obj/machinery/atmospherics/pipe/smart/manifold4w/supply/hidden{
	dir = 4
	},
/turf/open/floor/plating,
/area/space)
"SI" = (
/obj/structure/railing/eva_handhold/directional/west,
/turf/closed/wall/mineral/plastitanium/nodiagonal,
/area/space)
"Ti" = (
/obj/effect/turf_decal/tile/red/half{
	dir = 8
	},
/turf/open/floor/iron/dark/smooth_half,
/area/space)
"Tu" = (
/obj/structure/shelf,
/obj/item/melee/tizirian_sword{
	pixel_x = -10
	},
/obj/item/melee/tizirian_sword{
	pixel_x = -3
	},
/obj/item/melee/tizirian_sword{
	pixel_x = 5
	},
/turf/open/floor/plating,
/area/space)
"Tv" = (
/obj/machinery/modular_computer/preset/engineering{
	dir = 1
	},
/obj/effect/turf_decal/tile/red/half{
	dir = 4
	},
/turf/open/floor/iron/dark/textured,
/area/space)
"TK" = (
/obj/machinery/door/airlock/external,
/turf/open/floor/catwalk_floor/iron_dark,
/area/space)
"Un" = (
/obj/structure/table/reinforced/plastitaniumglass,
/obj/effect/turf_decal/tile/red/half{
	dir = 4
	},
/turf/open/floor/iron/dark/textured,
/area/space)
"VR" = (
/obj/structure/cable,
/obj/structure/sign/flag/tizira/directional/north,
/obj/machinery/atmospherics/pipe/smart/manifold4w/supply/hidden{
	dir = 4
	},
/obj/effect/turf_decal/tile/red,
/turf/open/floor/iron/dark/smooth_large,
/area/space)
"VT" = (
/obj/machinery/computer/camera_advanced/shuttle_docker/syndicate/pirate{
	dir = 1;
	x_offset = 12;
	y_offset = 5;
	view_range = 10
	},
/turf/open/floor/iron/dark/textured,
/area/space)
"VY" = (
/obj/effect/turf_decal/tile/red/half{
	dir = 4
	},
/turf/open/floor/iron/dark,
/area/space)
"WA" = (
/obj/machinery/door/airlock/external,
/obj/machinery/atmospherics/pipe/smart/manifold4w/supply/hidden{
	dir = 4
	},
/turf/open/floor/catwalk_floor/iron_dark,
/area/space)
"Xw" = (
/obj/structure/chair/comfy/shuttle{
	dir = 8
	},
/turf/open/floor/iron/dark,
/area/space)
"XN" = (
/obj/structure/cable,
/turf/open/floor/plating,
/area/space)
"Yq" = (
/obj/structure/window/reinforced/survival_pod/spawner/directional/north,
/obj/machinery/door/window/survival_pod/left/directional/west,
/turf/open/floor/plating,
/area/space)
"YF" = (
/obj/structure/railing{
	color = "#36373a"
	},
/obj/effect/turf_decal/tile/red{
	dir = 4
	},
/turf/open/floor/iron/dark/smooth_half,
/area/space)

(1,1,1) = {"
MZ
MZ
MZ
MZ
MZ
MZ
MZ
MZ
MZ
MZ
MZ
MZ
MZ
MZ
MZ
MZ
MZ
MZ
MZ
MZ
MZ
MZ
MZ
MZ
MZ
MZ
MZ
MZ
MZ
MZ
"}
(2,1,1) = {"
MZ
MZ
MZ
MZ
MZ
MZ
MZ
MZ
MZ
MZ
ht
TK
SI
In
In
bn
MZ
MZ
MZ
bn
In
In
Bf
MZ
MZ
MZ
MZ
MZ
MZ
MZ
"}
(3,1,1) = {"
MZ
MZ
MZ
MZ
MZ
MZ
MZ
MZ
MZ
bn
In
Rf
In
LG
LG
In
bn
bn
bn
In
LG
Bm
In
bn
MZ
MZ
MZ
MZ
MZ
MZ
"}
(4,1,1) = {"
MZ
MZ
MZ
MZ
MZ
MZ
MZ
MZ
bn
In
In
WA
In
wF
wF
kd
zv
XN
lr
LG
LG
LG
Bm
In
bn
MZ
MZ
MZ
MZ
MZ
"}
(5,1,1) = {"
MZ
MZ
MZ
MZ
MZ
MZ
MZ
bn
In
Sf
LG
Em
LG
wF
LG
In
LG
LG
Bm
LG
LG
LG
LG
Bm
In
Bf
MZ
MZ
MZ
MZ
"}
(6,1,1) = {"
MZ
MZ
MZ
MZ
MZ
MZ
bn
In
wF
wF
wF
wF
wF
wF
LG
AC
LG
Bm
Bm
Bm
lr
lr
LG
LG
Bm
In
bn
MZ
MZ
MZ
"}
(7,1,1) = {"
MZ
MZ
MZ
MZ
MZ
bn
In
LG
wF
LG
LG
LG
LG
In
bn
bn
In
LG
LG
LG
LG
Bm
Bm
LG
LG
Bm
In
bn
MZ
MZ
"}
(8,1,1) = {"
MZ
MZ
MZ
MZ
nD
In
oS
LG
wF
LG
LG
LG
In
bn
MZ
MZ
bn
In
In
In
In
In
In
In
In
In
In
In
bn
MZ
"}
(9,1,1) = {"
MZ
MZ
Ag
tX
In
GI
LG
LG
wF
In
In
In
Bf
MZ
MZ
MZ
MZ
MZ
MZ
MZ
MZ
MZ
MZ
MZ
MZ
MZ
MZ
MZ
MZ
MZ
"}
(10,1,1) = {"
MZ
MZ
Ag
tX
cE
IB
iJ
In
kd
In
pW
pW
Ja
Je
MZ
MZ
MZ
MZ
MZ
MZ
MZ
MZ
MZ
MZ
MZ
MZ
MZ
MZ
MZ
MZ
"}
(11,1,1) = {"
MZ
Ag
tX
In
In
In
In
In
wF
In
gG
In
bn
zh
MZ
MZ
MZ
MZ
MZ
MZ
MZ
MZ
MZ
MZ
MZ
MZ
MZ
MZ
MZ
MZ
"}
(12,1,1) = {"
MZ
Ag
tX
Bi
Ba
In
IS
wF
ee
Rf
Rf
LS
AC
MZ
MZ
MZ
MZ
MZ
MZ
MZ
MZ
MZ
MZ
MZ
MZ
MZ
MZ
MZ
MZ
MZ
"}
(13,1,1) = {"
MZ
Ag
tX
QC
Ba
In
Xw
wF
Rf
VY
xm
Tv
AC
MZ
MZ
MZ
MZ
MZ
MZ
MZ
MZ
MZ
MZ
MZ
MZ
MZ
MZ
MZ
MZ
MZ
"}
(14,1,1) = {"
MZ
bn
In
ao
In
In
In
wF
fA
ex
VY
Un
AC
AC
MZ
MZ
MZ
MZ
MZ
MZ
MZ
MZ
MZ
MZ
MZ
MZ
MZ
MZ
MZ
MZ
"}
(15,1,1) = {"
MZ
bn
Ba
QC
pO
Bi
In
VR
AT
YF
zk
te
LS
AC
MZ
MZ
MZ
MZ
MZ
MZ
MZ
MZ
MZ
MZ
MZ
MZ
MZ
MZ
MZ
MZ
"}
(16,1,1) = {"
MZ
bn
rA
QC
QC
QC
kd
cv
qc
wI
At
SA
yj
AC
MZ
MZ
MZ
MZ
MZ
MZ
MZ
MZ
MZ
MZ
MZ
MZ
MZ
MZ
MZ
MZ
"}
(17,1,1) = {"
MZ
bn
Is
QC
jl
jl
In
lS
Ti
fF
zk
pF
VT
AC
MZ
MZ
MZ
MZ
MZ
MZ
MZ
MZ
MZ
MZ
MZ
MZ
MZ
MZ
MZ
MZ
"}
(18,1,1) = {"
MZ
bn
In
ao
In
In
In
wF
JW
dO
uo
vw
AC
AC
MZ
MZ
MZ
MZ
MZ
MZ
MZ
MZ
MZ
MZ
MZ
MZ
MZ
MZ
MZ
MZ
"}
(19,1,1) = {"
MZ
Ag
tX
QC
Bi
Ba
In
qm
wF
uo
Dv
Fd
AC
MZ
MZ
MZ
MZ
MZ
MZ
MZ
MZ
MZ
MZ
MZ
MZ
MZ
MZ
MZ
MZ
MZ
"}
(20,1,1) = {"
MZ
Ag
tX
Ba
Ba
Ba
In
Rf
ee
Rf
Rf
do
AC
MZ
MZ
MZ
MZ
MZ
MZ
MZ
MZ
MZ
MZ
MZ
MZ
MZ
MZ
MZ
MZ
MZ
"}
(21,1,1) = {"
MZ
Ag
tX
In
In
In
In
In
wF
Rf
Rf
In
bn
kC
EI
MZ
MZ
MZ
MZ
MZ
MZ
MZ
MZ
MZ
MZ
MZ
MZ
MZ
MZ
MZ
"}
(22,1,1) = {"
MZ
MZ
Ag
tX
DB
SG
LG
In
kd
In
In
bn
Dl
MZ
MZ
MZ
MZ
MZ
MZ
MZ
MZ
MZ
MZ
MZ
MZ
MZ
MZ
MZ
MZ
MZ
"}
(23,1,1) = {"
MZ
MZ
Ag
tX
In
SG
SG
SG
wF
LG
LG
In
Bf
MZ
MZ
MZ
MZ
MZ
MZ
MZ
MZ
MZ
MZ
MZ
MZ
MZ
MZ
MZ
MZ
MZ
"}
(24,1,1) = {"
MZ
MZ
MZ
MZ
nD
In
LG
LG
wF
LG
LG
LG
In
bn
MZ
MZ
bn
In
In
In
In
In
In
In
In
In
In
In
bn
MZ
"}
(25,1,1) = {"
MZ
MZ
MZ
MZ
MZ
bn
In
LG
wF
LG
LG
LG
LG
In
bn
bn
In
LG
LG
LG
LG
Bm
LG
LG
LG
Bm
In
bn
MZ
MZ
"}
(26,1,1) = {"
MZ
MZ
MZ
MZ
MZ
MZ
bn
In
wF
wF
wF
wF
wF
wF
wF
kd
wF
wF
XN
LG
LG
qp
Bm
LG
Bm
In
bn
MZ
MZ
MZ
"}
(27,1,1) = {"
MZ
MZ
MZ
MZ
MZ
MZ
MZ
bn
In
LG
LG
Yq
vV
vV
RO
In
In
WA
In
Bm
Bm
lr
LG
Bm
In
Bf
MZ
MZ
MZ
MZ
"}
(28,1,1) = {"
MZ
MZ
MZ
MZ
MZ
MZ
MZ
MZ
bn
In
LG
eY
LG
LG
JM
In
LG
Em
In
lr
LG
LG
Bm
In
bn
MZ
MZ
MZ
MZ
MZ
"}
(29,1,1) = {"
MZ
MZ
MZ
MZ
MZ
MZ
MZ
MZ
MZ
bn
In
Tu
yW
LG
zX
In
zT
TK
zT
In
LG
Bm
In
bn
MZ
MZ
MZ
MZ
MZ
MZ
"}
(30,1,1) = {"
MZ
MZ
MZ
MZ
MZ
MZ
MZ
MZ
MZ
MZ
bn
In
In
In
In
bn
MZ
MZ
MZ
bn
In
In
Bf
MZ
MZ
MZ
MZ
MZ
MZ
MZ
"}
