//MAP CONVERTED BY dmm2tgm.py THIS HEADER COMMENT PREVENTS RECONVERSION, DO NOT REMOVE
"a" = (
/turf/template_noop,
/area/template_noop)
"c" = (
/obj/machinery/door/airlock/external,
/obj/effect/mapping_helpers/airlock/cutaiwire,
/obj/effect/mapping_helpers/airlock/cyclelink_helper{
	dir = 1
	},
/obj/machinery/atmospherics/pipe/smart/manifold4w/supply/hidden/layer4,
/obj/machinery/atmospherics/pipe/smart/manifold4w/scrubbers/hidden/layer2,
/turf/open/floor/catwalk_floor/iron_dark,
/area/shuttle/personally_bought/tiziran_interceptor)
"d" = (
/obj/structure/railing/eva_handhold/directional/west,
/obj/machinery/atmospherics/pipe/smart/manifold4w/scrubbers/hidden/layer2,
/turf/closed/wall/mineral/plastitanium/nodiagonal,
/area/shuttle/personally_bought/tiziran_interceptor)
"e" = (
/obj/structure/chair/comfy/shuttle{
	dir = 4
	},
/obj/effect/landmark/ship_captain_spawner,
/turf/open/floor/plating,
/area/shuttle/personally_bought/tiziran_interceptor)
"f" = (
/obj/machinery/power/shuttle_engine/heater{
	dir = 8
	},
/turf/closed/wall/mineral/plastitanium/nodiagonal,
/area/shuttle/personally_bought/tiziran_interceptor)
"g" = (
/obj/structure/guncase,
/obj/item/ammo_box/magazine/ammo_stack/bolt_slug/full,
/obj/item/ammo_box/magazine/ammo_stack/bolt_slug/full,
/obj/item/gun/ballistic/bolt_thrower,
/obj/machinery/atmospherics/components/unary/vent_scrubber/on/layer2{
	dir = 8
	},
/turf/open/floor/plating,
/area/shuttle/personally_bought/tiziran_interceptor)
"h" = (
/obj/machinery/suit_storage_unit/pirate{
	helmet_type = /obj/item/clothing/head/helmet/space/pirate/tiziran_raider;
	suit_type = /obj/item/clothing/suit/space/pirate/tiziran
	},
/obj/machinery/atmospherics/components/unary/vent_pump/on/layer4{
	dir = 4
	},
/turf/open/floor/plating,
/area/shuttle/personally_bought/tiziran_interceptor)
"i" = (
/obj/machinery/portable_atmospherics/canister/air,
/obj/machinery/atmospherics/components/unary/portables_connector/visible/layer4{
	dir = 4
	},
/turf/open/floor/plating,
/area/shuttle/personally_bought/tiziran_interceptor)
"j" = (
/obj/machinery/atmospherics/pipe/smart/manifold4w/scrubbers/hidden/layer2,
/turf/closed/wall/mineral/plastitanium/nodiagonal,
/area/shuttle/personally_bought/tiziran_interceptor)
"k" = (
/obj/machinery/door/airlock/external,
/obj/effect/mapping_helpers/airlock/cutaiwire,
/obj/structure/fans/tiny,
/obj/docking_port/mobile/personally_bought{
	dir = 2;
	port_direction = 8
	},
/obj/effect/mapping_helpers/airlock/cyclelink_helper,
/turf/open/floor/catwalk_floor/iron_dark,
/area/shuttle/personally_bought/tiziran_interceptor)
"l" = (
/obj/machinery/airalarm/directional/west,
/obj/effect/mapping_helpers/airalarm/all_access,
/obj/structure/closet/firecloset/shuttle,
/turf/open/floor/plating,
/area/shuttle/personally_bought/tiziran_interceptor)
"n" = (
/obj/structure/railing/eva_handhold/directional/north,
/turf/closed/wall/mineral/plastitanium/nodiagonal,
/area/shuttle/personally_bought/tiziran_interceptor)
"o" = (
/turf/closed/wall/mineral/plastitanium/nodiagonal,
/area/shuttle/personally_bought/tiziran_interceptor)
"p" = (
/obj/machinery/door/poddoor/shutters/preopen{
	id = "interceptor"
	},
/obj/effect/spawner/structure/window/reinforced/plasma/plastitanium,
/obj/structure/cable,
/turf/open/floor/plating,
/area/shuttle/personally_bought/tiziran_interceptor)
"q" = (
/obj/machinery/atmospherics/pipe/smart/manifold4w/scrubbers/hidden/layer2,
/obj/machinery/wall_healer/free/directional/west,
/turf/open/floor/plating,
/area/shuttle/personally_bought/tiziran_interceptor)
"r" = (
/obj/structure/cable,
/obj/machinery/computer/camera_advanced/shuttle_docker/personally_bought{
	dir = 8
	},
/turf/open/floor/plating,
/area/shuttle/personally_bought/tiziran_interceptor)
"s" = (
/obj/machinery/porta_turret/syndicate,
/turf/closed/wall/mineral/plastitanium,
/area/shuttle/personally_bought/tiziran_interceptor)
"t" = (
/obj/machinery/power/shuttle_engine/heater{
	dir = 8
	},
/obj/machinery/atmospherics/pipe/smart/manifold4w/scrubbers/hidden/layer2,
/turf/closed/wall/mineral/plastitanium/nodiagonal,
/area/shuttle/personally_bought/tiziran_interceptor)
"u" = (
/obj/structure/cable,
/obj/machinery/computer/shuttle/personally_bought{
	dir = 8
	},
/turf/open/floor/catwalk_floor/iron_dark,
/area/shuttle/personally_bought/tiziran_interceptor)
"v" = (
/obj/item/tether_anchor{
	anchored = 1
	},
/obj/structure/railing/eva_handhold/directional/north,
/turf/closed/wall/mineral/plastitanium/nodiagonal,
/area/shuttle/personally_bought/tiziran_interceptor)
"x" = (
/obj/machinery/atmospherics/pipe/smart/manifold4w/supply/hidden/layer4,
/obj/machinery/atmospherics/pipe/smart/manifold4w/scrubbers/hidden/layer2,
/obj/structure/cable,
/obj/machinery/door/window/survival_pod/left/directional/west,
/obj/machinery/light/small/red/directional/north,
/turf/open/floor/catwalk_floor/iron_dark,
/area/shuttle/personally_bought/tiziran_interceptor)
"y" = (
/obj/machinery/power/shuttle_engine/propulsion{
	dir = 8
	},
/obj/machinery/atmospherics/components/unary/passive_vent/layer2{
	dir = 4
	},
/turf/open/floor/plating/airless,
/area/shuttle/personally_bought/tiziran_interceptor)
"z" = (
/obj/machinery/atmospherics/components/unary/vent_scrubber/on/layer2{
	dir = 8
	},
/obj/structure/cable,
/turf/open/floor/catwalk_floor/iron_dark,
/area/shuttle/personally_bought/tiziran_interceptor)
"A" = (
/obj/machinery/atmospherics/pipe/smart/manifold4w/supply/hidden/layer4,
/obj/machinery/atmospherics/pipe/smart/manifold4w/scrubbers/hidden/layer2,
/turf/open/floor/catwalk_floor/iron_dark,
/area/shuttle/personally_bought/tiziran_interceptor)
"B" = (
/obj/structure/railing/eva_handhold/directional/west,
/turf/closed/wall/mineral/plastitanium/nodiagonal,
/area/shuttle/personally_bought/tiziran_interceptor)
"C" = (
/obj/structure/railing/eva_handhold/directional/south,
/turf/closed/wall/mineral/plastitanium/nodiagonal,
/area/shuttle/personally_bought/tiziran_interceptor)
"D" = (
/obj/machinery/atmospherics/pipe/smart/manifold4w/supply/hidden/layer4,
/obj/machinery/atmospherics/pipe/smart/manifold4w/scrubbers/hidden/layer2,
/turf/open/floor/plating,
/area/shuttle/personally_bought/tiziran_interceptor)
"E" = (
/obj/structure/window/reinforced/survival_pod/spawner/directional/west,
/obj/machinery/light/small/red/directional/south,
/obj/structure/closet/crate/cardboard/tiziran,
/obj/item/reagent_containers/cup/soda_cans/doppler/kortara,
/obj/item/reagent_containers/cup/soda_cans/doppler/kortara,
/obj/item/reagent_containers/cup/soda_cans/doppler/kortara,
/obj/item/reagent_containers/cup/soda_cans/doppler/kortara,
/obj/item/reagent_containers/cup/soda_cans/doppler/kortara,
/obj/item/reagent_containers/cup/soda_cans/doppler/kortara,
/turf/open/floor/plating,
/area/shuttle/personally_bought/tiziran_interceptor)
"G" = (
/obj/item/tether_anchor{
	anchored = 1
	},
/turf/closed/wall/mineral/plastitanium/nodiagonal,
/area/shuttle/personally_bought/tiziran_interceptor)
"H" = (
/obj/machinery/atmospherics/pipe/smart/manifold4w/supply/hidden/layer4,
/obj/machinery/atmospherics/pipe/smart/manifold4w/scrubbers/hidden/layer2,
/obj/structure/sign/poster/contraband/dolphin/directional/south,
/turf/open/floor/plating,
/area/shuttle/personally_bought/tiziran_interceptor)
"I" = (
/obj/machinery/power/micro_reactor,
/obj/structure/cable,
/obj/structure/window/reinforced/survival_pod/spawner/directional/north,
/turf/open/floor/plating,
/area/shuttle/personally_bought/tiziran_interceptor)
"J" = (
/obj/machinery/atmospherics/pipe/smart/manifold4w/supply/hidden/layer4,
/obj/machinery/light/small/red/directional/west,
/obj/machinery/atmospherics/pipe/smart/manifold4w/scrubbers/hidden/layer2,
/turf/open/floor/plating,
/area/shuttle/personally_bought/tiziran_interceptor)
"K" = (
/obj/machinery/power/shuttle_engine/propulsion{
	dir = 8
	},
/turf/open/floor/plating/airless,
/area/shuttle/personally_bought/tiziran_interceptor)
"L" = (
/obj/machinery/atmospherics/pipe/smart/manifold4w/supply/hidden/layer4,
/obj/machinery/atmospherics/pipe/smart/manifold4w/scrubbers/hidden/layer2,
/obj/structure/cable,
/turf/open/floor/catwalk_floor/iron_dark,
/area/shuttle/personally_bought/tiziran_interceptor)
"M" = (
/obj/machinery/suit_storage_unit/pirate{
	helmet_type = /obj/item/clothing/head/helmet/space/pirate/tiziran_raider;
	suit_type = /obj/item/clothing/suit/space/pirate/tiziran
	},
/obj/machinery/atmospherics/components/unary/vent_scrubber/on/layer2{
	dir = 8
	},
/turf/open/floor/plating,
/area/shuttle/personally_bought/tiziran_interceptor)
"O" = (
/obj/structure/closet/firecloset/shuttle/tools,
/obj/machinery/atmospherics/components/unary/vent_pump/on/layer4{
	dir = 8
	},
/turf/open/floor/plating,
/area/shuttle/personally_bought/tiziran_interceptor)
"P" = (
/obj/structure/chair/comfy/shuttle{
	dir = 4
	},
/obj/structure/window/reinforced/survival_pod/spawner/directional/west,
/turf/open/floor/plating,
/area/shuttle/personally_bought/tiziran_interceptor)
"Q" = (
/obj/machinery/atmospherics/components/unary/vent_pump/on/layer4{
	dir = 8
	},
/obj/machinery/atmospherics/pipe/smart/manifold4w/scrubbers/hidden/layer2,
/obj/structure/cable,
/obj/machinery/power/apc/auto_name/directional/north,
/obj/effect/mapping_helpers/apc/syndicate_access,
/obj/effect/mapping_helpers/apc/cell_10k,
/turf/open/floor/catwalk_floor/iron_dark,
/area/shuttle/personally_bought/tiziran_interceptor)
"R" = (
/obj/item/tether_anchor{
	anchored = 1
	},
/obj/structure/railing/eva_handhold/directional/south,
/turf/closed/wall/mineral/plastitanium/nodiagonal,
/area/shuttle/personally_bought/tiziran_interceptor)
"S" = (
/turf/closed/wall/mineral/plastitanium,
/area/shuttle/personally_bought/tiziran_interceptor)
"T" = (
/obj/structure/window/reinforced/survival_pod/spawner/directional/north,
/obj/structure/shelf,
/obj/item/melee/tizirian_sword{
	pixel_x = -3
	},
/obj/item/melee/tizirian_sword{
	pixel_x = 5
	},
/turf/open/floor/plating,
/area/shuttle/personally_bought/tiziran_interceptor)
"U" = (
/obj/machinery/turretid{
	pixel_y = -24
	},
/obj/machinery/button/door{
	id = "interceptor";
	name = "Cockpit Shutters Control";
	pixel_y = -34;
	pixel_x = -3
	},
/obj/machinery/modular_computer/preset/engineering{
	dir = 8
	},
/turf/open/floor/plating,
/area/shuttle/personally_bought/tiziran_interceptor)
"V" = (
/obj/machinery/door/poddoor/shutters/preopen{
	id = "piratebridge"
	},
/obj/effect/spawner/structure/window/reinforced/plasma/plastitanium,
/obj/structure/cable,
/turf/open/floor/plating,
/area/shuttle/personally_bought/tiziran_interceptor)
"W" = (
/obj/machinery/atmospherics/pipe/smart/manifold4w/supply/hidden/layer4,
/obj/machinery/atmospherics/pipe/smart/manifold4w/scrubbers/hidden/layer2,
/obj/structure/cable,
/obj/structure/extinguisher_cabinet/directional/north,
/turf/open/floor/catwalk_floor/iron_dark,
/area/shuttle/personally_bought/tiziran_interceptor)

(1,1,1) = {"
K
y
a
a
a
a
K
K
"}
(2,1,1) = {"
f
t
d
j
G
B
f
f
"}
(3,1,1) = {"
n
h
o
q
T
l
i
C
"}
(4,1,1) = {"
k
A
c
L
J
D
H
o
"}
(5,1,1) = {"
v
M
o
W
I
O
g
R
"}
(6,1,1) = {"
S
o
o
x
P
E
o
S
"}
(7,1,1) = {"
a
s
o
Q
U
o
s
a
"}
(8,1,1) = {"
a
a
V
z
e
p
a
a
"}
(9,1,1) = {"
a
a
V
u
r
V
a
a
"}
(10,1,1) = {"
a
a
s
V
V
s
a
a
"}
