//MAP CONVERTED BY dmm2tgm.py THIS HEADER COMMENT PREVENTS RECONVERSION, DO NOT REMOVE
"b" = (
/obj/machinery/cryopod{
	dir = 8
	},
/obj/machinery/time_clock/directional/east,
/turf/open/floor/iron/dark/textured_large,
/area/station/commons/cryopods)
"c" = (
/obj/machinery/cryopod{
	dir = 4
	},
/turf/open/floor/iron/dark/textured_large,
/area/station/commons/cryopods)
"d" = (
/obj/structure/cable,
/obj/machinery/atmospherics/pipe/smart/manifold4w/supply/hidden/layer4,
/obj/effect/landmark/start/hangover,
/obj/structure/disposalpipe/segment{
	dir = 8
	},
/obj/effect/turf_decal/trimline/yellow/arrow_ccw{
	dir = 6
	},
/obj/effect/turf_decal/trimline/yellow/arrow_ccw{
	dir = 6
	},
/obj/machinery/atmospherics/pipe/smart/manifold4w/scrubbers/hidden/layer2,
/turf/open/floor/iron/corner{
	dir = 1
	},
/area/station/hallway/secondary/exit/departure_lounge)
"e" = (
/obj/effect/spawner/structure/window,
/turf/open/floor/plating,
/area/station/commons/cryopods)
"f" = (
/obj/structure/falsewall,
/turf/open/floor/plating,
/area/station/maintenance/starboard/fore)
"g" = (
/obj/effect/turf_decal/siding/thinplating_new/light{
	dir = 8
	},
/obj/effect/turf_decal/siding/thinplating_new/light{
	dir = 4
	},
/turf/open/floor/iron/dark,
/area/station/commons/cryopods)
"m" = (
/obj/effect/turf_decal/siding/thinplating_new/light/corner{
	dir = 1
	},
/obj/effect/turf_decal/siding/thinplating_new/light/corner{
	dir = 4
	},
/turf/open/floor/iron/dark/side,
/area/station/commons/cryopods)
"n" = (
/turf/closed/wall,
/area/station/maintenance/starboard/fore)
"o" = (
/obj/structure/cable,
/obj/machinery/atmospherics/pipe/smart/manifold4w/supply/hidden/layer4,
/obj/machinery/atmospherics/pipe/smart/manifold4w/scrubbers/hidden/layer2,
/obj/structure/disposalpipe/segment{
	dir = 4
	},
/turf/open/floor/iron/dark/side{
	dir = 10
	},
/area/station/commons/cryopods)
"p" = (
/obj/item/radio/intercom/directional/west,
/obj/effect/turf_decal/siding/thinplating_new/light{
	dir = 1
	},
/obj/machinery/atmospherics/components/unary/vent_scrubber/on/layer2,
/turf/open/floor/iron/dark/side{
	dir = 9
	},
/area/station/commons/cryopods)
"r" = (
/obj/machinery/atmospherics/pipe/smart/manifold4w/supply/hidden/layer4,
/turf/open/floor/iron/dark/side{
	dir = 8
	},
/area/station/commons/cryopods)
"u" = (
/obj/structure/closet/emcloset,
/turf/open/floor/iron/dark,
/area/station/commons/cryopods)
"v" = (
/obj/effect/turf_decal/siding/thinplating_new/light{
	dir = 8
	},
/obj/effect/turf_decal/siding/thinplating_new/light{
	dir = 4
	},
/turf/open/floor/iron/dark/side{
	dir = 1
	},
/area/station/commons/cryopods)
"x" = (
/obj/structure/cable,
/obj/machinery/atmospherics/pipe/smart/manifold4w/supply/hidden/layer4,
/obj/structure/disposalpipe/segment{
	dir = 8
	},
/obj/effect/turf_decal/trimline/dark/corner,
/obj/effect/turf_decal/trimline/dark/corner,
/obj/machinery/atmospherics/pipe/smart/manifold4w/scrubbers/hidden/layer2,
/turf/open/floor/iron,
/area/station/hallway/secondary/exit/departure_lounge)
"y" = (
/turf/open/floor/iron/dark,
/area/station/commons/cryopods)
"z" = (
/obj/machinery/computer/cryopod/directional/north,
/obj/effect/turf_decal/siding/thinplating_new/light{
	dir = 8
	},
/obj/effect/turf_decal/siding/thinplating_new/light{
	dir = 4
	},
/turf/open/floor/iron/dark/side,
/area/station/commons/cryopods)
"A" = (
/obj/machinery/door/airlock/maintenance,
/obj/effect/mapping_helpers/airlock/access/all/engineering/maintenance,
/obj/effect/mapping_helpers/airlock/unres{
	dir = 1
	},
/turf/open/floor/plating,
/area/station/maintenance/starboard/fore)
"B" = (
/obj/effect/turf_decal/siding/thinplating_new/light{
	dir = 1
	},
/obj/machinery/atmospherics/components/unary/vent_pump/on/layer4,
/obj/machinery/camera/directional/east,
/turf/open/floor/iron/dark/side{
	dir = 5
	},
/area/station/commons/cryopods)
"C" = (
/obj/machinery/cryopod{
	dir = 8
	},
/obj/machinery/light/directional/east,
/turf/open/floor/iron/dark/textured_large,
/area/station/commons/cryopods)
"E" = (
/obj/machinery/cryopod{
	dir = 8
	},
/turf/open/floor/iron/dark/textured_large,
/area/station/commons/cryopods)
"F" = (
/turf/template_noop,
/area/template_noop)
"K" = (
/obj/machinery/airalarm/directional/south,
/obj/machinery/atmospherics/pipe/smart/manifold4w/supply/hidden/layer4,
/obj/structure/cable,
/obj/structure/disposalpipe/segment{
	dir = 4
	},
/turf/open/floor/iron/dark/side{
	dir = 1
	},
/area/station/commons/cryopods)
"L" = (
/turf/closed/wall,
/area/station/commons/cryopods)
"M" = (
/obj/structure/cable,
/obj/machinery/atmospherics/pipe/smart/manifold4w/supply/hidden/layer4,
/obj/machinery/power/apc/auto_name/directional/east,
/obj/structure/disposalpipe/segment{
	dir = 10
	},
/turf/open/floor/iron/dark/side{
	dir = 6
	},
/area/station/commons/cryopods)
"N" = (
/obj/structure/cable,
/obj/machinery/atmospherics/pipe/smart/manifold4w/supply/hidden/layer4,
/obj/structure/disposalpipe/segment{
	dir = 8
	},
/obj/machinery/door/airlock/public/glass{
	name = "Cryopods"
	},
/obj/machinery/atmospherics/pipe/smart/manifold4w/scrubbers/hidden/layer2,
/obj/machinery/door/firedoor,
/turf/open/floor/iron/dark,
/area/station/commons/cryopods)
"O" = (
/obj/structure/cable,
/obj/machinery/atmospherics/pipe/smart/manifold4w/supply/hidden/layer4,
/obj/structure/disposalpipe/segment{
	dir = 8
	},
/obj/effect/turf_decal/trimline/yellow/arrow_ccw,
/obj/effect/turf_decal/trimline/yellow/arrow_ccw,
/obj/machinery/atmospherics/pipe/smart/manifold4w/scrubbers/hidden/layer2,
/turf/open/floor/iron,
/area/station/hallway/secondary/exit/departure_lounge)
"P" = (
/obj/machinery/atmospherics/pipe/smart/manifold4w/supply/hidden/layer4,
/obj/structure/cable,
/obj/structure/disposalpipe/segment{
	dir = 5
	},
/turf/open/floor/iron/dark,
/area/station/commons/cryopods)
"S" = (
/obj/machinery/atmospherics/pipe/smart/manifold4w/scrubbers/hidden/layer2,
/obj/machinery/light/directional/west,
/turf/open/floor/iron/dark/side{
	dir = 4
	},
/area/station/commons/cryopods)
"T" = (
/obj/item/toy/plush/shark{
	name = "Chompies the Fifth"
	},
/obj/effect/decal/cleanable/blood/gibs/old,
/turf/open/floor/plating,
/area/station/maintenance/starboard/fore)
"U" = (
/obj/structure/cable,
/obj/machinery/atmospherics/pipe/smart/manifold4w/supply/hidden/layer4,
/obj/structure/disposalpipe/junction/flip{
	dir = 4
	},
/obj/machinery/atmospherics/pipe/smart/manifold4w/scrubbers/hidden/layer2,
/turf/open/floor/iron,
/area/station/hallway/secondary/exit/departure_lounge)
"X" = (
/obj/structure/cable,
/obj/effect/landmark/start/assistant,
/obj/machinery/atmospherics/pipe/smart/manifold4w/supply/hidden/layer4,
/obj/structure/disposalpipe/junction/flip{
	dir = 4
	},
/obj/effect/turf_decal/trimline/dark/arrow_ccw,
/obj/effect/turf_decal/trimline/dark/arrow_ccw,
/obj/machinery/atmospherics/pipe/smart/manifold4w/scrubbers/hidden/layer2,
/turf/open/floor/iron,
/area/station/hallway/secondary/exit/departure_lounge)
"Z" = (
/obj/machinery/atmospherics/pipe/smart/manifold4w/supply/hidden/layer4,
/obj/structure/cable,
/obj/structure/disposalpipe/segment{
	dir = 4
	},
/obj/machinery/door/airlock/public/glass{
	name = "Cryopods"
	},
/obj/machinery/door/firedoor,
/turf/open/floor/iron/dark,
/area/station/commons/cryopods)

(1,1,1) = {"
F
F
F
F
F
F
x
F
F
F
"}
(2,1,1) = {"
F
F
F
F
F
F
O
F
F
F
"}
(3,1,1) = {"
F
F
F
F
F
F
X
F
F
F
"}
(4,1,1) = {"
F
F
F
F
F
F
d
F
F
F
"}
(5,1,1) = {"
F
F
F
F
F
F
U
F
F
F
"}
(6,1,1) = {"
L
L
L
e
L
L
N
n
F
F
"}
(7,1,1) = {"
L
c
c
c
p
S
o
A
F
F
"}
(8,1,1) = {"
L
z
v
g
m
y
K
L
n
f
"}
(9,1,1) = {"
L
b
C
E
B
r
M
P
n
T
"}
(10,1,1) = {"
L
L
L
e
L
u
L
Z
n
n
"}
