//MAP CONVERTED BY dmm2tgm.py THIS HEADER COMMENT PREVENTS RECONVERSION, DO NOT REMOVE
"a" = (
/turf/open/misc/grass/roofing,
/area/space)
"e" = (
/obj/effect/turf_decal/weather/snow/corner{
	dir = 10
	},
/obj/effect/turf_decal/weather/snow/corner{
	dir = 4
	},
/turf/open/misc/sandy_dirt/icemoon,
/area/space)
"i" = (
/obj/structure/lamppost{
	dir = 8
	},
/turf/open/misc/asteroid/snow/icemoon,
/area/space)
"j" = (
/obj/structure/flora/bush/sparsegrass/style_random,
/obj/effect/turf_decal/weather/snow/corner{
	dir = 5
	},
/obj/effect/turf_decal/weather/snow/corner{
	dir = 8
	},
/turf/open/misc/sandy_dirt/icemoon,
/area/space)
"m" = (
/obj/effect/turf_decal/weather/snow/corner{
	dir = 5
	},
/obj/effect/turf_decal/weather/snow/corner{
	dir = 10
	},
/turf/open/misc/sandy_dirt/icemoon,
/area/space)
"o" = (
/turf/open/misc/asteroid/snow/icemoon,
/area/space)
"B" = (
/obj/structure/flora/bush/sparsegrass/style_random,
/obj/effect/turf_decal/weather/snow/corner{
	dir = 5
	},
/obj/effect/turf_decal/weather/snow/corner,
/turf/open/misc/sandy_dirt/icemoon,
/area/space)
"D" = (
/obj/effect/turf_decal/weather/snow/corner{
	dir = 5
	},
/obj/effect/turf_decal/weather/snow/corner{
	dir = 8
	},
/turf/open/misc/sandy_dirt/icemoon,
/area/space)
"K" = (
/turf/open/openspace/icemoon,
/area/space)
"N" = (
/obj/effect/turf_decal/weather/snow/corner{
	dir = 10
	},
/turf/open/misc/sandy_dirt/icemoon,
/area/space)
"S" = (
/turf/closed/mineral/snowmountain/icemoon/unscrapeable,
/area/space)
"Y" = (
/obj/structure/stairs/stone,
/turf/open/misc/asteroid/snow/icemoon,
/area/space)

(1,1,1) = {"
o
o
o
o
K
K
K
K
o
o
o
o
o
o
o
"}
(2,1,1) = {"
o
m
o
K
K
K
K
K
K
K
o
o
o
o
o
"}
(3,1,1) = {"
m
o
K
K
K
K
K
K
K
K
K
o
o
o
o
"}
(4,1,1) = {"
o
o
a
a
a
a
K
K
K
K
K
o
o
o
o
"}
(5,1,1) = {"
o
K
a
a
a
a
K
K
K
K
K
K
o
o
o
"}
(6,1,1) = {"
o
K
a
a
a
a
K
K
K
K
K
K
o
o
o
"}
(7,1,1) = {"
o
K
a
a
a
a
K
K
K
K
K
K
o
o
o
"}
(8,1,1) = {"
o
K
a
a
a
a
K
K
K
K
K
K
o
o
o
"}
(9,1,1) = {"
o
K
a
a
a
a
K
K
K
K
K
K
o
o
S
"}
(10,1,1) = {"
o
K
a
a
a
a
K
K
K
K
K
o
o
o
S
"}
(11,1,1) = {"
o
K
a
a
a
a
K
K
K
K
o
o
o
S
S
"}
(12,1,1) = {"
o
K
K
K
K
K
K
K
K
o
o
o
o
S
S
"}
(13,1,1) = {"
o
o
K
K
K
K
K
K
o
o
o
S
S
S
S
"}
(14,1,1) = {"
j
N
o
K
K
o
o
o
o
o
S
S
S
S
S
"}
(15,1,1) = {"
i
B
o
o
o
D
e
o
m
Y
S
S
S
S
S
"}
