//MAP CONVERTED BY dmm2tgm.py THIS HEADER COMMENT PREVENTS RECONVERSION, DO NOT REMOVE
"a" = (
/turf/open/misc/asteroid/snow/icemoon,
/area/icemoon/surface/outdoors/less_spawns)
"v" = (
/obj/structure/lamppost{
	dir = 8
	},
/obj/structure/flora/bush/sparsegrass/style_random,
/obj/effect/turf_decal/weather/snow/corner{
	dir = 5
	},
/obj/effect/turf_decal/weather/snow/corner{
	dir = 10
	},
/turf/open/misc/sandy_dirt/icemoon,
/area/icemoon/surface/outdoors/less_spawns)
"L" = (
/obj/structure/statue/hearthkin/odin,
/obj/effect/turf_decal/weather/snow/corner{
	dir = 10
	},
/obj/effect/turf_decal/weather/snow/corner{
	dir = 5
	},
/turf/open/misc/sandy_dirt/icemoon,
/area/icemoon/surface/outdoors/less_spawns)
"S" = (
/turf/open/openspace/icemoon,
/area/icemoon/surface/outdoors/less_spawns)
"Z" = (
/obj/effect/turf_decal/weather/snow/corner{
	dir = 5
	},
/obj/effect/turf_decal/weather/snow/corner{
	dir = 10
	},
/turf/open/misc/sandy_dirt/icemoon,
/area/icemoon/surface/outdoors/less_spawns)

(1,1,1) = {"
a
a
a
a
a
a
a
a
a
a
a
a
a
a
a
"}
(2,1,1) = {"
a
a
a
a
a
S
S
S
S
a
a
a
a
a
a
"}
(3,1,1) = {"
a
a
a
a
a
a
S
S
S
S
a
a
a
a
a
"}
(4,1,1) = {"
a
a
S
S
a
a
a
S
S
S
S
a
a
a
a
"}
(5,1,1) = {"
a
a
S
S
S
a
a
S
S
S
S
a
a
a
a
"}
(6,1,1) = {"
a
S
S
S
S
a
a
S
S
S
S
S
a
a
a
"}
(7,1,1) = {"
a
S
S
S
S
a
a
S
S
S
S
S
a
a
a
"}
(8,1,1) = {"
a
S
S
S
a
a
a
S
S
S
S
S
a
a
a
"}
(9,1,1) = {"
a
a
a
S
a
a
a
a
S
S
S
S
a
a
a
"}
(10,1,1) = {"
a
S
a
a
a
a
a
a
S
S
S
a
a
a
a
"}
(11,1,1) = {"
a
S
S
S
S
S
a
a
a
S
a
a
a
a
a
"}
(12,1,1) = {"
a
a
S
S
a
a
a
a
a
a
a
a
a
a
a
"}
(13,1,1) = {"
a
a
a
a
a
a
a
S
S
a
a
a
L
a
a
"}
(14,1,1) = {"
a
a
a
a
S
S
S
S
S
S
a
Z
a
v
a
"}
(15,1,1) = {"
a
a
a
a
a
S
S
S
S
S
Z
a
a
a
a
"}
