//MAP CONVERTED BY dmm2tgm.py THIS HEADER COMMENT PREVENTS RECONVERSION, DO NOT REMOVE
"a" = (
/turf/open/misc/asteroid/snow/icemoon,
/area/ruin/unpowered/primitive_genemod_den)
"b" = (
/obj/effect/turf_decal/weather/snow/corner{
	dir = 4
	},
/turf/open/misc/sandy_dirt/icemoon,
/area/ruin/unpowered/primitive_genemod_den)
"c" = (
/obj/effect/turf_decal/weather/snow/corner{
	dir = 6
	},
/obj/effect/turf_decal/weather/snow/corner{
	dir = 1
	},
/turf/open/misc/sandy_dirt/icemoon,
/area/ruin/unpowered/primitive_genemod_den)
"d" = (
/obj/effect/turf_decal/weather/snow/corner{
	dir = 8
	},
/turf/open/misc/sandy_dirt/icemoon,
/area/ruin/unpowered/primitive_genemod_den)
"e" = (
/obj/effect/turf_decal/weather/snow/corner{
	dir = 8
	},
/obj/structure/flora/bush/sparsegrass/style_random,
/turf/open/misc/sandy_dirt/icemoon,
/area/ruin/unpowered/primitive_genemod_den)
"f" = (
/obj/structure/railing/wooden_fencing{
	dir = 4
	},
/turf/open/misc/asteroid/snow/icemoon,
/area/ruin/unpowered/primitive_genemod_den)
"h" = (
/obj/structure/bonfire/prelit,
/obj/structure/railing/wooden_fencing,
/obj/structure/railing/wooden_fencing{
	dir = 4
	},
/obj/structure/railing/wooden_fencing{
	dir = 1
	},
/obj/structure/railing/wooden_fencing{
	dir = 8
	},
/turf/open/misc/sandy_dirt/icemoon,
/area/ruin/unpowered/primitive_genemod_den)
"i" = (
/obj/structure/railing/wooden_fencing,
/obj/effect/turf_decal/weather/snow/corner{
	dir = 6
	},
/obj/effect/turf_decal/weather/snow/corner{
	dir = 9
	},
/turf/open/misc/sandy_dirt/icemoon,
/area/ruin/unpowered/primitive_genemod_den)
"k" = (
/obj/structure/rack/wooden,
/obj/item/pickaxe{
	pixel_x = -5
	},
/obj/item/pickaxe{
	pixel_x = 5
	},
/obj/item/ore_sensor{
	pixel_y = -5;
	pixel_x = 5
	},
/obj/item/storage/backpack/satchel/crusader,
/obj/item/storage/backpack/satchel/crusader{
	pixel_x = 7
	},
/turf/open/misc/sandy_dirt/icemoon,
/area/ruin/unpowered/primitive_genemod_den)
"l" = (
/obj/structure/railing/wooden_fencing/gate,
/turf/open/misc/asteroid/snow/icemoon,
/area/ruin/unpowered/primitive_genemod_den)
"m" = (
/obj/effect/turf_decal/weather/snow/corner{
	dir = 10
	},
/obj/effect/turf_decal/weather/snow/corner{
	dir = 5
	},
/turf/open/misc/sandy_dirt/icemoon,
/area/ruin/unpowered/primitive_genemod_den)
"n" = (
/turf/open/misc/sandy_dirt/icemoon,
/area/ruin/unpowered/primitive_genemod_den)
"o" = (
/obj/effect/turf_decal/weather/snow/corner,
/obj/structure/flora/bush/sparsegrass/style_random,
/turf/open/misc/sandy_dirt/icemoon,
/area/ruin/unpowered/primitive_genemod_den)
"p" = (
/obj/effect/mob_spawn/ghost_role/human/primitive_genemod,
/turf/open/misc/sandy_dirt/icemoon,
/area/ruin/unpowered/primitive_genemod_den)
"q" = (
/obj/structure/table/wood,
/obj/item/reagent_containers/cup/glass/bottle/moonshine{
	pixel_x = 8
	},
/obj/item/seeds/tea/catnip{
	pixel_x = -5
	},
/obj/item/seeds/poppy{
	pixel_x = -5;
	pixel_y = 5
	},
/obj/item/seeds/aloe{
	pixel_y = 9;
	pixel_x = -7
	},
/turf/open/misc/sandy_dirt/icemoon,
/area/ruin/unpowered/primitive_genemod_den)
"v" = (
/obj/effect/turf_decal/weather/snow/corner{
	dir = 5
	},
/obj/effect/turf_decal/weather/snow/corner,
/turf/open/misc/sandy_dirt/icemoon,
/area/ruin/unpowered/primitive_genemod_den)
"w" = (
/obj/structure/lamppost,
/obj/effect/turf_decal/weather/snow/corner{
	dir = 9
	},
/obj/effect/turf_decal/weather/snow/corner,
/turf/open/misc/sandy_dirt/icemoon,
/area/ruin/unpowered/primitive_genemod_den)
"x" = (
/obj/machinery/chem_dispenser/spice_rack{
	pixel_y = 32
	},
/obj/structure/rack/wooden,
/obj/item/knife/hunting{
	pixel_y = 5
	},
/obj/item/cutting_board,
/turf/open/misc/sandy_dirt/icemoon,
/area/ruin/unpowered/primitive_genemod_den)
"y" = (
/obj/structure/stairs/stone{
	dir = 1
	},
/turf/open/misc/asteroid/snow/icemoon,
/area/ruin/unpowered/primitive_genemod_den)
"A" = (
/obj/effect/turf_decal/weather/snow/corner,
/obj/structure/rugs/pelt,
/turf/open/misc/sandy_dirt/icemoon,
/area/ruin/unpowered/primitive_genemod_den)
"B" = (
/obj/effect/turf_decal/weather/snow/corner{
	dir = 6
	},
/obj/effect/turf_decal/weather/snow/corner{
	dir = 8
	},
/obj/structure/flora/bush/sparsegrass/style_random,
/turf/open/misc/sandy_dirt/icemoon,
/area/ruin/unpowered/primitive_genemod_den)
"C" = (
/obj/structure/rugs/pelt/black{
	dir = 4;
	pixel_y = -15
	},
/turf/open/misc/sandy_dirt/icemoon,
/area/ruin/unpowered/primitive_genemod_den)
"E" = (
/obj/effect/turf_decal/weather/snow/corner{
	dir = 6
	},
/turf/open/misc/sandy_dirt/icemoon,
/area/ruin/unpowered/primitive_genemod_den)
"G" = (
/turf/closed/wall/mineral/wood/nonmetal,
/area/ruin/unpowered/primitive_genemod_den)
"H" = (
/turf/closed/mineral/snowmountain/icemoon/unscrapeable,
/area/ruin/unpowered/primitive_genemod_den)
"I" = (
/obj/structure/railing/wooden_fencing{
	dir = 1
	},
/obj/structure/railing/wooden_fencing{
	dir = 4
	},
/turf/open/misc/asteroid/snow/icemoon,
/area/ruin/unpowered/primitive_genemod_den)
"J" = (
/obj/effect/turf_decal/weather/snow/corner{
	dir = 9
	},
/obj/effect/turf_decal/weather/snow/corner{
	dir = 6
	},
/turf/open/misc/sandy_dirt/icemoon,
/area/ruin/unpowered/primitive_genemod_den)
"K" = (
/obj/structure/railing/wooden_fencing/gate{
	dir = 4
	},
/turf/open/misc/asteroid/snow/icemoon,
/area/ruin/unpowered/primitive_genemod_den)
"M" = (
/obj/structure/calling_horn/hearthkin,
/obj/effect/turf_decal/weather/snow/corner{
	dir = 6
	},
/turf/open/misc/sandy_dirt/icemoon,
/area/ruin/unpowered/primitive_genemod_den)
"N" = (
/obj/structure/railing/wooden_fencing{
	dir = 4
	},
/obj/structure/railing/wooden_fencing,
/turf/open/misc/asteroid/snow/icemoon,
/area/ruin/unpowered/primitive_genemod_den)
"O" = (
/obj/machinery/vending/primitive_genemod_clothing_vendor,
/turf/open/misc/sandy_dirt/icemoon,
/area/ruin/unpowered/primitive_genemod_den)
"P" = (
/obj/effect/turf_decal/weather/snow/corner,
/obj/effect/turf_decal/weather/snow/corner{
	dir = 1
	},
/turf/open/misc/sandy_dirt/icemoon,
/area/ruin/unpowered/primitive_genemod_den)
"Q" = (
/obj/effect/turf_decal/weather/snow/corner{
	dir = 10
	},
/obj/effect/turf_decal/weather/snow/corner{
	dir = 1
	},
/turf/open/misc/sandy_dirt/icemoon,
/area/ruin/unpowered/primitive_genemod_den)
"S" = (
/obj/structure/railing/wooden_fencing{
	dir = 1
	},
/turf/open/misc/asteroid/snow/icemoon,
/area/ruin/unpowered/primitive_genemod_den)
"U" = (
/obj/item/flashlight/lantern/on{
	pixel_y = 5
	},
/turf/open/misc/sandy_dirt/icemoon,
/area/ruin/unpowered/primitive_genemod_den)
"V" = (
/mob/living/basic/cow/yak,
/turf/open/misc/asteroid/snow/icemoon,
/area/ruin/unpowered/primitive_genemod_den)
"W" = (
/obj/structure/railing/wooden_fencing{
	dir = 4
	},
/obj/effect/turf_decal/weather/snow/corner{
	dir = 10
	},
/obj/effect/turf_decal/weather/snow/corner{
	dir = 4
	},
/turf/open/misc/sandy_dirt/icemoon,
/area/ruin/unpowered/primitive_genemod_den)
"X" = (
/obj/structure/railing/wooden_fencing,
/turf/open/misc/asteroid/snow/icemoon,
/area/ruin/unpowered/primitive_genemod_den)
"Z" = (
/obj/effect/turf_decal/weather/snow/corner,
/turf/open/misc/sandy_dirt/icemoon,
/area/ruin/unpowered/primitive_genemod_den)

(1,1,1) = {"
H
H
H
H
y
a
a
a
a
a
a
a
a
a
a
"}
(2,1,1) = {"
H
H
H
m
a
a
a
a
a
a
a
a
a
a
a
"}
(3,1,1) = {"
H
a
m
a
a
a
a
a
a
a
a
a
a
a
a
"}
(4,1,1) = {"
a
Q
G
G
G
G
W
f
f
f
f
f
a
a
a
"}
(5,1,1) = {"
a
v
G
x
n
Z
a
w
a
J
V
X
a
a
a
"}
(6,1,1) = {"
a
a
G
q
n
A
a
P
a
a
a
i
a
a
a
"}
(7,1,1) = {"
a
a
G
O
C
n
d
n
e
e
B
l
a
a
a
"}
(8,1,1) = {"
a
a
G
n
n
n
n
n
h
o
a
X
a
a
a
"}
(9,1,1) = {"
a
a
G
n
p
n
n
n
b
Z
a
X
a
a
a
"}
(10,1,1) = {"
a
m
G
k
n
U
n
M
a
c
a
X
a
a
a
"}
(11,1,1) = {"
a
a
G
G
G
G
E
a
a
a
a
X
a
a
a
"}
(12,1,1) = {"
a
a
a
a
a
a
S
a
a
a
a
X
a
a
a
"}
(13,1,1) = {"
a
a
a
a
a
a
I
f
K
f
f
N
a
a
a
"}
(14,1,1) = {"
a
a
a
a
a
a
a
a
a
a
a
a
a
a
a
"}
(15,1,1) = {"
a
a
a
a
a
a
a
a
a
a
a
a
a
a
a
"}
